000001001000000
000001111111111
000011111111110
000111101111100
000110001111000
001110001111110
001100100111100
011000000011100
110000000001111
100000000111001
101010111110001
110001100011001
011111000001101
000000000000111
000000000000011