000000010000000
000001111100000
110001111101110
111001111111011
011001111110001
011001111100001
011011111110001
011011111110011
011011111110110
011111111111100
011111111110000
001111111111000
000111111111000
000111111111000
000111111111000