000001110000000
001111011000000
011111101111110
011111101100001
010111101100001
011111101110011
011111101111111
111111011111111
010001111111111
010001111111111
010001111111111
010101111001111
011101111001111
000001111001111
000001111001111