000011100000000
000100010000000
001101010000000
001101100000000
011100000000000
111110000000000
111111111111110
001111111111111
001111111111111
000111111111111
000011100001111
000001000000101
000001000000100
000001000000100
000011000001100