111010000011100
110000000111011
001000000111111
100011110011110
000110111011100
001011010101110
011010110111110
111011110111110
111000000111110
011111011111100
011111111111000
111011001111000
111011001101100
100110001101100
110111000110110