000001111110000
000010100111000
000100000011100
000101010011110
000100000011110
000010001111110
001111110001110
010000000101110
100111111010110
101100000100111
010011111000111
000001000000111
000111000000011
001110000000011
011100000000011