000111000000000
001111100000111
001111100000001
001111100001111
101010101111000
100111001000000
111111111100111
011111110111100
111111111000000
101111101111001
101010110001101
101011011000111
101101001110000
110101110011110
010100011100011