001111100111100
011001000010110
110110000001011
100100111011001
110011110110011
011010101011110
011100000001100
111011000011010
100011100111001
001000100101101
111100100101011
111101011010000
111010111110000
111011000110000
110001111100000