001101100001100
000010000010010
000000000010110
011111000100111
100000110101000
011110011101100
001000000110100
000111100010010
111010000011010
100111111001001
100000000000001
110000000000011
111100000001110
110011111111001
001111000001111