001111000000000
100011100000000
110011100000000
110001110000000
111001110000000
111111001100000
011110011101100
000011111011110
000001000111111
011101111101111
010000111110111
010110111111011
000100111111101
000100011111110
000000001111111