000001101100000
000011111110000
000011111110000
000011111110000
011101111101110
111110111011111
111111010111111
011111101111110
111111010111111
111110010011111
011100010001110
000000110000000
000001100000000
001111000000000
001100000000000