000011111100000
000111111110000
000111001111000
000000000111100
000000000011100
000000000111110
000100010111011
000100010000001
001111111000011
011111111100010
011100011100010
011000001100110
111000001110100
111100011111100
111111111110000