001011001100001
001111101110000
001011000110000
000000000011000
110011110011000
111111011110000
001111101110110
011111111111111
001111111110110
111111111110000
110011110011000
000000000011010
101100000110011
111110001110010
101100001100000