011111000000000
110001100000000
100100111000000
111000111110000
101001100011000
111100110001100
000100011100110
000011000110011
000011000011001
000001100001101
000011011101111
111100010101011
111110111001000
000011111101110
000000000111111