000111111111000
000100011000000
011110101110010
111110001100111
111110011100010
110010000100000
101110011110000
000110111111000
000001111111000
000001111111100
000001111111100
011100111111100
010111111111110
000100000100111
000000011110011