000010000000000
001110000000000
011111000000000
000011000000000
000011100000000
000011111111010
000011111111101
000111111111101
011111111101101
010010000101100
010010000010110
001010000010010
000100000010010
000100000100010
001000000000100