011110000000111
110010000001100
100010000001000
101111111111100
101000000000100
110111111111000
011111111110000
000001111100000
000000111000000
000000010000000
000000010000000
000000010000000
000000010000000
000000010000000
000011111110000