000011110000000
000110011000000
001101001100000
111100000101100
000111001100110
000011011000111
000110110001111
001101100111111
011011011111111
110111111111111
100111111111101
110011111111011
011001111110110
001100000001100
000111111111000