000111111111000
011100000011110
110000000011111
100000000011111
100100100010111
100100000011111
111100011100111
001000011100011
001000001000110
011111111111100
110011110111100
101000011100110
101100100010010
111100111110010
000111100011110