000111000001110
001101100011011
001001111111001
001111111111111
000111011101110
001111111111110
001111000001110
001110011100110
001111000001100
000111111111011
011111111111111
111111111111111
111111111111111
111111111111110
110111111111000