000000000000000
000011001100000
000011111100000
000010110100011
000011111100111
000010000101110
000001001011100
000111111111000
001111010110000
011101101101000
001111111100100
010111111100110
100011111100010
111101101101110
000011101110000