000001111100000
000011111110000
000110010011000
000110010011000
000111111111000
011011111111000
111001111100110
111101010100111
001110000011111
000111101111000
000001111110000
011011111100110
111111001111111
111110000111111
011100000001110