101111111111101
000111111111000
110010000010011
111100000001111
111000000000111
111001101100111
111011101110111
111101000101111
111100010001111
111010000010111
111101111101111
111100101001111
110010000010011
000111111111000
101111111111101