000000000000111
000001111001111
000001001011110
011111011111100
010011001111000
010111111110000
010011111000000
011111110000000
011111100000000
111111000000000
111110000000000
111100000000000
110001010000101
111111111111111
111111111111111