110100000001011
111111111111111
110100111001011
110100111001011
000110111011000
000010010010000
000011111110000
000001111100000
000000111000000
000000111000000
000001111100000
000001000100000
000011000110000
000011000110000
001111000111100