010000001000000
111000011100000
010000011100000
010011111111100
010010000000100
010010001000110
110110011100101
111010111110101
010010111110110
010010001000111
010010011100111
010010000000100
010011111111100
010000010010000
010001110011000