000000011111100
000001111111110
111001111111111
001101111111111
000101111111111
000101111111111
001101001100111
011001101110110
110000111111100
110011111111000
011000001111110
001100011111111
100111111011101
110001101010110
011111011011011