000111100000000
001100001111000
011111000001100
110000000111110
110000000000011
110010111010011
110001111100011
111011111110111
011111111111110
100111111111001
011111111111110
100111111111001
011111111111110
100011111110001
100000000000001