000111100000000
011111110000000
111110111000001
110110011000111
111100111001110
111001110001100
000011101101110
001111011110110
011011110110110
111100001110110
111111111101110
110111111011110
111000000111100
011111111111000
001111111110000