000111111000000
011111111110000
110000000011000
100000000001000
100001100001000
110111111011000
011111111110000
111111111110111
111111111111110
111111111111110
111111111111110
111111111111100
111111111111100
011111111111000
001111111110000