001000001111000
001100011001110
001110011000000
001010011100000
001010001100000
111000001110000
111000110111000
110011110111100
000111110011110
000111111001111
001111111100111
001111111110111
000000111111111
000000011111111
000000001111111