000000010000000
000000101000000
000000010000000
000000101000000
000001110100000
000011011110000
000110110111000
000011101110000
000110111011000
001111111110100
011101110111110
000111011011000
001101101110100
011111011111110
110111101101111