111111000111111
111100000001111
110000000000011
110000000000011
100001111100001
100011000110001
000110000011000
100100000001001
011111111111110
100111111111001
000011111110000
110000000000000
000001100000011
110000000111000
000111000000011