000000000001111
001000000111100
000000000100000
101010001110000
000000001110000
001000001010000
000011111111100
000010000000100
000010101010100
111111111111111
100000000000001
110000000000001
011000000000011
001111111111110
111111111111111