010000000000010
101111111111101
011111111011110
011111110111110
011111101110110
011001111101110
011100111011110
010110011111110
010111001111110
010111100111110
010111110011110
010011111001110
011000000111110
101111111111101
010000000000010