000000000010101
000000111001110
000001101111011
000001000001110
000011100010101
001111111000000
011111111100000
011111110100000
111111111110000
111111110110000
111111110110000
011111110100000
011111111100000
001111111000000
000011100000000