000001001111000
000000111000100
000000010001111
110000010000110
111110001011100
101011111010010
101000000010000
101100010010000
110111110110000
111000001100000
001110111001110
000101111111110
000100000111100
000111100000000
000111110000000