011100000001110
111011111110111
110110010011011
101100010001101
011000010000110
010000010000010
010000010000010
011000110000110
010001100000010
010011000000010
011000000000110
001100000001100
000110010011000
000111111111000
011100000001110