101010001111100
101010011111110
101010010001110
101010011010110
110110010000010
011100001000100
001000000111100
001000001000110
001000111000010
010111001000101
010100111000101
001111001000101
001000000111111
001000000111101
001000000111110