001110000000011
011001000000110
010010100001110
011001000011010
001110000110010
011100001100010
111100011000010
101111111000010
100111100000010
100100000000010
110111110000101
010110110000010
111101100001010
000101100000100
000101111000000