111011110000000
001010010000000
011111000000000
010001000000000
011011110000000
001111111000000
000101111100000
000001111110000
011111111110000
010001111111011
001110111101111
001001110011111
000110011111111
000101110111111
000001001010111