000000111110000
000001110001000
000001100101111
100001000101110
100001100001100
110000110011110
111001111111000
111111111011100
011111110001100
001111110001100
000111100011100
001110000111000
000011111110001
100010100000101
111011010111111