000011111110000
001111000111100
000010101010000
000001000110000
001111101111111
001000011000001
010111000011110
011101001010011
011001000011001
000010001001000
000011110011000
101000011100000
101010001000101
111111001001111
101010001000101