000001111110000
000111001011100
001100101010110
011010000000010
110000000000111
111000000000001
111101111000011
111111001100001
111110000100011
011100101100001
000110111000111
000100000000010
000110100010110
000011001011100
000001111110000