101000000000000
010000000000000
001000000000000
111000011111100
010000111111110
101000100000010
100000101111010
011100011111100
010110111111110
001001100000011
000110001111101
000010000000101
000011000001001
000001100000011
001111111111111