010010001110000
110110111000000
100100100000000
100101110000000
110111000000000
110111100000000
011011000000000
001101111100000
010011100110000
011000101101111
001111000000001
000011110000010
000011011111100
000111000110000
001110001100000