000011100000000
000000110011111
000000010111110
000000011111100
000000010000000
011111010111100
111111111111110
111111111101111
111111110111111
111111111110111
111111111111110
111111111111110
011111111111100
001111111111000
000111011110000