111111111111111
111111111111111
110011110011111
110100001011000
111100001110000
110010100000000
110111110010000
101100011001000
101010101001000
101100011001000
110111110010000
110000001110000
111111111000000
111000000000000
111001110011110