001111110000100
000101111001010
001010111000100
000100011000010
000011110100011
000110101110101
001111011111111
011111011111110
101011011110011
110110001110010
001110001110100
001101110100100
000101011010000
001011001001000
011110000111100