000000100011110
000000100100001
000011111101110
110111111110001
001111111110001
000111110011110
011111101111001
100111011111101
100011011010101
100110111111101
101001101101100
101001000101010
101001000000010
001001000000100
000100100000000