000000000010000
000010000110000
000011001111000
000111101111000
000111100110010
010011000000110
011000000001111
111100111001111
111101111100110
011011111110000
000011111111000
000111111111000
000111111111000
000111101111000
000011000110000