111100000011111
100111000110111
100001100101011
100000110100001
100000010110000
100000010011101
100000111000111
011100011111111
111110001111111
110110000001111
111110000111111
011111100111111
000011000110110
000010000110110
000000001110111