011111100000000
111111110000000
111111110000000
111100100111110
111010100100010
111000100010100
110000010001000
110000110001000
111000100001000
111000100010100
011011001111111
001010000010010
011111000010100
111111100111000
111111111111000