111000000001110
101110000011011
001111000000001
100111100000011
000111111111010
000111011111010
011000111110010
111111110100010
111111101010010
001010100010010
010101100100011
110101011000101
101101010011111
111001111111110
011111111111010