000000111100000
000001111110101
000001100100010
001101001100000
010011100101000
011111111001000
010110000110100
010100111111100
010111100001000
011000110001000
001010001001000
010111101001000
100100101001000
111000111001000
111100111101000