011100000000000
010110000000111
010011011101101
011001111111011
011011101110010
001110110101110
001000010000100
011111000111110
010011101110110
010000101000010
010110111011011
111001010110110
001100111001101
010111000111000
000001111100000