000000010000000
000000111000000
000000010000000
000000111000000
001110111011100
011011101110110
110001000100011
110001000100011
011111111111110
001111111111100
000100000001000
000111111111000
001111111111100
001111111111100
001111111111100