000001010100000
000011010110000
000011101010000
000011111010000
000001110100000
000000111000000
001110010000000
011101010011100
110011010110110
100001111101010
000000111000111
000000010000001
000111111111000
000010100010000
000010111110000