000011111110000
001111111111100
011111111101110
111111111110111
111111111110111
111111111110111
011111111111110
000001000100000
000011000110000
000010000010000
000110000011000
000100000001000
000100000001000
000110000011000
000011111110000