010111101000000
000100100000000
110101101100000
000111100000000
010110001000000
000110000000110
111111011101111
100000100010001
101101011101001
100010110010101
100010111010101
100010111110101
100001011101001
100000100010001
011111111111110