000001111000000
000001001000000
000111111110000
011111111111100
101101101101110
111111111111111
111111111111111
101111101111101
111101111101111
111000111000111
000111000111000
101111101111101
111101111101110
011111111111100
000111111110000