001110000001100
011111000000100
010011000000100
010011011111100
000000010000100
000000010100100
000000100010100
010000100110100
111111111111110
101111111100011
111111111011101
110001111010101
110101111011101
010001000100010
001110000011100