000001111111000
000111111111100
001110111011110
001101111110110
010001101111111
000001001101101
000001001100101
000000001100000
000000001101110
011100001111111
111110001110101
101101001100100
001000001100100
101000111111110
111111111111111