111010101101111
110101010101011
110010101010101
101101110100011
110101000101101
101110101011001
100000110101011
110111001010101
100010110010011
111101001101101
111110000111111
111110000111111
111110000101101
111110000100001
111110000101101