000000000011011
000011110000100
000100001000000
000110101000000
011110001000000
011111010000000
000010100000000
000010100000110
000010111111010
000100000000010
111100100011011
101100011110111
111110000001100
100111111111111
111111111000111