111000111001111
111011010110111
111011101110111
100011101110001
011101101101110
011110101011110
101111000111101
110000000000011
101111000111101
011110101011110
011101101101110
000011101110000
111011101110111
111011010110111
111100111001111