000111000111000
001100101001100
001100010001100
000110010011000
000011010110000
000001111100000
001111101111100
001111101111100
001111101111100
000000010000000
001111101111100
001111101111100
001111101111100
001111101111100
000111101111000