001100000001100
011111111111110
011110000011110
011100000001110
001011000110100
001010000010100
001011010110100
001100000001100
000111111111000
011110000001110
011100000001110
000100000001000
000110000011000
001111111111100
001110000011100