000000011100000
000001111111000
001110110100000
011111111000000
011011001100011
011011001111110
110110010111000
110111110000000
010111111000000
010011011100000
010011101100000
010001111100000
010011110000000
000011011000000
000010011100000