000001000111110
000001001111110
000001000100110
000001000101110
001111111111111
001111111100011
001111111011110
000011110111111
000111100110011
000110100110011
000011000011110
111111111111111
110111111111011
101111001110111
011110011101110