000000001000000
000000011100000
000000111110000
000000010100000
000001111111000
000000100010000
000000100110000
000000100010000
000001110110000
000001000010000
001111111011100
001010101011100
011111111111111
011010111110111
110000000000001