000000000000000
001110000011100
011111000111110
111111100111111
111111100111111
111111101111111
111111011111111
011111011111110
011111101111110
001111011111100
000110111111000
000010111110000
000000111100000
000000111000000
000000010000000