111110011111111
111100000011111
111000010000011
110000111000111
110000000001101
101111000011001
100001111010001
101100001101001
101100000101001
100011000100001
100011000100101
100000110100011
110000110100111
111110000101111
111111110111111