000001111100000
000000111000000
000000010000000
010000010000010
101000010000101
101010010010111
010101000101010
000111010101000
010010010010010
010000010000010
010010010010010
010010010010010
011111111111111
001111111111110
000000010000000