000001111100000
000111000111000
000011111110000
000011101110000
000010000010000
000010010010000
001111000111100
011001101100110
111011101110111
110010101010111
110110111010110
010110101011100
011111101111000
001101000101100
011111000111110