000000111110000
000001000011111
000000000111010
110000000001100
011100000001110
000111110011110
001100011110110
001001000000110
001011110000100
001111011111110
011110000110011
110011001100001
100001001000001
100001001000010
010000100100000