000000000000000
000000010000000
000001111100000
000000111000000
000001111100011
011101111100111
110111111110110
100011111111110
100011111111100
100011111111100
100011111110000
111011111110000
001111111110000
000011111110000
000001111100000