000001111100000
000110011111000
001001111111100
010011111111110
010110000011110
100100111001111
101100101001111
111100111001111
111100101001111
111100111001111
011110000011111
011111111111110
001111111111100
000111111111000
000001111100000