110111110111111
110000000011111
101110111001111
101011101001111
101110111000111
100001000000111
001001000000011
001100011001001
001111111100000
001111111101010
100001111100000
110001110010010
111000110010000
111100000010001
111110110110011