000011111100000
110011010010000
110000000110011
100001000110101
110000111111100
100101111111011
010011111111101
011011111101000
011110111111110
000101011011011
011110100110001
110001111000011
100010100000110
010100110000000
000110001100000