000000011110000
001110100111000
010001000011110
110000100010010
100110000010011
111111000111111
011111111111111
001011111100110
001001111000100
001000000000100
001000000000100
001000000000100
001000000000100
001000000000100
000111111111000