000111100000000
000011111000000
000001111111000
000011111101110
000111111011111
000111111110011
001111011001110
001100011111000
011001111011000
011010001001000
010100001000110
010110000011101
010001001100010
100111011011001
111000110111100