000000001111111
000000111000110
000001100001100
000011011111000
000010110000000
000101000000000
001010001111111
111111101000000
100000101011101
011111001000000
011101001011011
111110101000000
111110101011101
111110101000000
011111001111111