000100100001100
000000000001110
000011001101111
100111011101111
001111111110110
001110011000100
000100011100100
001100001101000
011110001111110
011111010111110
010111001011100
111110110000001
111111111000011
011001111001010
000000000010110