000000011111000
000000010010000
000000011111000
000000010000000
000001101100000
000110111011000
011001010100110
110010010010011
101100010001101
101111111111101
101101111101101
101101101101101
111101101101111
001101101101100
000011111110000