111100001111111
111001100111111
000001000111011
100100001110111
111110001110001
111100011100011
111001100000011
110001000000111
110001100110111
110000111100100
011000000001110
001111111111100
100001111000001
011100000011110
000111111110000