000000000000000
000000001000000
000000011000000
000000111000001
000001111100011
000011111110111
000110111111110
000111111111111
010011111110011
010001111100001
011000111000000
001100011001000
011000001001100
001100000000100
111111111111111