000000000111000
000110001111100
001111001111110
011011101101000
010111111001000
110111011110011
111110000100100
111111010011110
011101111001010
000100001111100
000011111000100
000011011100100
000111011100100
000110001100100
110111001110101