000011110000000
001111111100000
011111111100000
011111111110000
011110001111000
011100100001100
011111100100011
011111100000001
001111000000011
010000000001110
011111000011000
011111100010000
011111100110000
011111101100000
011111111000000