000011111110000
000110000011000
000100101001000
000100101001000
000110111011000
000111000111000
001110010011100
011111000111110
111110111011111
111100000001111
101100000001101
001100000001100
000100000001000
001111000111100
111001101100111