110000010000011
111000111000111
111001111100111
111111111111111
101110111011101
101110111011101
000110010011000
000011111110000
000001111100000
000001111110000
000000111110000
000000001100000
000000011001000
000000011110000
000000001100000