000000100000100
110010110001110
011111111011110
011101111011110
011110110110110
001111010110111
011111101111011
111100010111011
001111111011011
000001111101011
001111111110110
111111100001100
011110011111110
000111111110011
001111011000001