000000011000000
000001100100000
000001110100000
000000000010000
000011111010000
000111111101000
000101010101000
001111111110100
001001010010100
001111111110100
001001010010000
000111111100000
000101010100000
000011111000000
000001110000000