000100000000000
000010000001000
000110000001110
011100000001101
110011110001110
110111111011100
111111111111100
011111111111100
001111111111100
001111101111000
011101100111100
111001101101110
100001001000011
100001001000001
010000100100000