000001111100000
000111111111000
001111111111100
011111001111010
011110110110010
111110110000011
111111010000111
111111100101111
101111000000101
110110000000011
110110000011111
101100000011111
101100000001111
101100000001111
110000000000111