001010000000011
000100111000101
100000011100111
110001111110000
101011101011001
110110101101100
010000010000100
110111000001001
101101100110001
111000111100011
100000011000111
000100110010111
110110001110110
011011011100010
000100110000001