011001111100111
010110111011011
101110110101111
101110110000011
101110111110000
111110001110001
111100110101101
110010110101101
111111001110101
111111111100011
101111111110001
101111100011000
010110011001110
010101110000000
110011001110011