011111110111000
111110001111100
111100000011100
011111001111110
011101101010110
011100100010110
001100100000110
001100000001110
011010000101100
000010111101100
000010011001000
000001000110100
000001111100100
000000110000111
000111111000011