000000000000000
000001111000000
000000111000000
000001111100000
000001111100000
000011111110000
000100010001000
000101010101000
000101010101000
001100010001100
001111111111100
011100000001110
011110000011110
001111111111100
000000000000000