111110011101000
111101101111000
111011110110100
111011101111011
100111011111110
011010111111111
011010110111111
100111010101011
111111101000001
111111111101000
111111101100000
111000001110001
100000000111111
010011110000111
010000011000000