111111111110001
101110111100000
010101010101010
111011101010101
111111111000000
111111111001110
101110111001110
010101010100100
111011101110101
111111111111011
011001100110100
100011001100101
100010001000001
110001100110010
011000111011100