000011110111000
001111111111100
001111111111110
011100111100111
011000001000001
110111001011101
110001101110001
110011111111101
011100110110111
001000001100011
001101100010001
011100101000011
111110011100110
110011110111100
100000000000000