000011111111000
000110000111100
011100100001110
110100000001111
111101111100111
111100000011011
111110111100011
111011000011001
100001101001101
101001100110001
001111110011001
000111100001011
000000100000011
000011000000111
000111100001111