001111100111000
010111010110100
011010110101100
001010100111100
101000101111110
111000111101110
111101111010110
111101111110011
111101111001001
111111100000001
111000000000111
111100000000011
111000011011101
111001111101101
001011111101111