010101011111111
101010101110001
101010110101110
101010110110011
101010110100101
101010101100001
111110011110001
111001011111101
111111100111011
111111111110001
111111111100011
111111000100010
111110000010000
111000110000001
100001111100011