011111111111100
111001111100110
110100111001010
110001111100010
111011010110001
101111111111100
011001111100100
010100000001101
110110111011001
100110111011000
001110111011111
001110111011111
001110111011101
011100000001101
001001111100111