001111000010100
001111000010100
011111100011110
011011100011010
111011100111111
110011001111111
000111011111100
000110111111000
001111111110000
001111111111100
001111111111110
001111111110010
000111111100000
000011111100000
000001111111000