111110010011111
111001101100111
110111000111011
110111101110101
110111000101110
101011111110001
011101100011111
100011011101111
111110111110111
011110111110111
001110111110111
100111011101111
110100001000011
110111111111111
101100000000011