111001110001110
110110111110011
110111011100101
101000100110001
110111011111001
110110111001100
111001000100000
111111100111011
101111010111000
110110111110001
111001111100001
111001111001100
110110111011100
101111010011110
011111111111110