000111000111000
000011111110000
000001111111100
000011000111110
000111010111010
001111000110010
001110111111111
001110111111111
101110111111111
110111010101010
111111100000110
011111111111100
000011111111000
000010010010000
000110011011000