010010011111111
101101101111111
101101101100011
101101101000001
101101101001100
101101101101110
101101100110110
111111010011100
111111111111100
111111111100000
001111100000001
110010000000111
100101010111011
111000110100101
110100101101101