100111001111111
011010110111111
011000110111101
110111011111011
101111101100011
101111101011001
101111101111101
110111010111000
111000100000000
111111001101100
111110000101000
111110010000010
011110010101010
010111011000110
101111011111110