000000111110000
000011000001100
000110111110110
000100000000010
000100011100010
000110111110110
000011000001100
110001111111000
011011111111100
011111101111110
001111011111110
000111011111110
000111111111110
001000000000001
000111111111110