000011111100000
000111111110000
000111111110001
000111100001111
000110011111111
101001100111110
111111111011100
011111010001000
000111000011000
000111110001110
000011100101010
000001001101001
000000111010011
000111110010111
001111100101111