000000011100000
000000111010000
011100111010000
100110111010000
110010011101110
111110001010011
011100011011101
001000010011111
000100100001110
110010100000100
011010001110010
011010011101001
111000011101001
110000011111010
001000001110010