111001100111111
110111111101111
111100010111001
101111111111100
111011100001110
111111000000100
111001001010000
100001001000001
000000110000111
000000000011011
000000000011111
010000000111111
010001100111111
110011100110001
110011100100100