000111111111000
001100011111100
011000001111110
110011000111111
100111100111111
100111100111111
100011001111111
100000011111111
100000111001111
100001110000111
100001110000111
110001111001111
011000111111110
001100011111100
000111111111000