000000000110000
000000001011000
000000101001000
000001110001000
000011100001000
000111110011000
001111011111000
010001111111100
110000110101110
110000111111110
011000110101111
011000011111101
101000011111011
110000001110110
110000000011100