000000000110000
000111001001000
001001001001000
001000111111000
001001111010000
000111101110000
000001111110000
000000111110000
000001101000000
000011110100001
000111111000011
000111100100111
111111110110111
100001111000000
111100000000000