000001001100010
001011100110110
011000110011100
001100011111001
100111000111001
110001111110011
011111001110110
000000000111100
001111100111001
011000110011101
010001010001111
111111111001110
110111011011110
011111110011110
011000110111100