011000000011110
101000011110000
100101110000000
100100000000001
001100111000011
101101000100111
101001111100110
010010000010101
010011111110011
010100000001001
010111111111001
001000000000101
001111111111100
010000000000010
111111111111111