000000000000000
001110000001110
010001111110001
010101000010101
011111000011111
010000000000001
010111111111101
010000000000001
001111111111110
001100000000110
010100000000101
001010100101010
010010111101001
011110100101111
000011100111000