111000000000000000000001100000
011100000000000000001111000000
001111000000000000111110000000
000111110000000011111110000000
000011111100000111111100000000
000011111111000111111000000000
000001110001101111111000000000
000001101110111111110000000000
000000101011011111110000000000
000000011111101111100000000000
000000010111011111100000000000
000000000111011111100000000000
000000000100111111000000000000
000000001101111111001100000000
100000001000111110001110000000
110000001011111101011111000000
110000001111111111111111100000
111000000111111111111111100000
111100000000011111111000000000
011100000011101110000000000000
011100000111001110000000000000
011110000110001110000000000111
001110001100000100000100001111
001111011100001100001110011111
000111000000011010011111011111
000011111110000001111111111111
000011111111111111111111111111
000001111111111111111100000000
000000111111111110000000000000
000000011111111100000000000000