111111111111111111111111111111
100000000001110000000000000001
100000000011110000000000000001
100000000011110000000000000001
100000000011111100000000000001
100000000001111111000000000001
100000000000011111110000000001
100000000000111111110000000001
100000000001111111111000000001
100000000001110011111100000001
100000000011100001111100000001
100000001111000111111100000001
100000011100011111111100000001
100001111100111111111100000001
100001100100111111110000000001
100000100111111111110000000001
100000001100001111110000000001
100111111010000111101111111001
101100001111000011101100000101
111000001011100011101100000011
110000010010010111110010000001
100000110011001111100000000001
100000110001000111111111100001
100000000001000111111001100001
100000000001000101100001000001
110000000010000011110000000001
110000001100000011110000000011
101100011000000011001000001101
100011110000000000000111110001
111111111111111111111111111111