000000111100000000000000000000
000001111111110000110000000000
000011111111111001111100000000
000011111111110011111110000000
000111111111100111111111000000
000111111111000011111110000000
001111111100000100011000000000
001111111100001110111000000000
001110001110011111010000000000
000000001111011111010000000000
000000001110001100010000000000
000000001011000110010000010000
000000000011000100110000111000
000111100011000100100001111100
001111110011000101100011111110
001111000001100101000000110000
011111100001101111000111100000
011001110001111110111100000000
000001011111111111100000000000
000000000000111110000000000000
000000000000001111000000000000
000000000011111111110000000000
000000000011111111110000000000
000000000011111111111000000000
000000000111111111111000000000
000000001111111111111111100000
000000111111111111111100110000
000011111111111111111110011000
000110000111101110111110111000
000011011111101101111101110000