000000000000000000000000000000
000000000001000000000000000000
000000000001000000000010000000
000000000011100000000010000000
000000000001000000000111000000
000000000001000000000010000000
000000000001000000000010000000
000000000011100000000010000000
000000000111110000000010000000
000000001111111000000010000000
010000011111111100000111000000
010000011111111100001111100000
010000011111111100011111110000
011000001111111000111111111000
011100001111111001111111111100
011111000000000011111111111110
011111101111111011111111111110
011111110011111011111111111110
011111111001111001111111111100
011111111101111011111111111110
011111111100111011111111111110
011111111110111000000000000000
011111111110111011111111111110
011111111100111011111111111110
011111111001111011111111111110
000000000011111011111111111110
011111111011111011111111111110
011111111011111011111111111110
011111111011111011111111111110
000000000000000000000000000000