000000000000000001000000000000
000000000000000001111010000000
111000000000000001110011110000
001111100000000011000011100000
000000111100011111111110000000
001101111111011010000111111100
111111111000010010000100000100
111110000000100100000100000100
000000000001101100000100000100
000000000011011100000100000100
000000000111111111111110000100
000000001110111100000011111110
000000011101111000000010000010
000000111011111000000010000010
000001111111111000000010000010
000011110111111000000010000010
000111101111111111111110000010
001000011111110000000011111110
111100100111110000000010000010
001111000001110000000010000010
000111111000010000000010000010
000011111111111000000010000010
000001111100011111111110000010
001101110000000111111111111111
011110100011110011111000111111
111110000111111000100000001100
000111001111111110000111100001
111111110000000110001111100011
111100000011110001111111111111
111000111111111100011100000000