000000000111000000000001110000
110000001101100000001111000000
011100011000110001111000000000
000111111111111111000000000000
000000011000110000000000000000
111111011000110111111111111111
000000011000110000000000000000
000111111111111111000000000000
011100110101011001111100000000
110000011111110000001111100000
000000011000110000000001111100
000000011010110000000000001111
000000111000111000000000000001
000000111111111000000000000000
000000110000011000000000000000
000000110010011000000000000000
000000110010011000000000000000
000000110000011111111111000000
000011111111111111111111100000
000001100000001000000110110000
000001110000101000001100011000
000001110000101000011000001100
000001100000101000110011100110
000001100110001111100010100111
000001100110001001000011100110
000001100110001001000000000110
000001100110001001000000000110
000001111111111111111111111110
000011000000000110000000000011
111111111111111111111111111111