000011111110000000000000000000
000010101010000000000000000000
000010100110000000000000000000
111111111111111111111100000000
111010101010101010101110000000
111111111111111111111100000000
000010101110000000001000000000
000011101010000000001000000000
000010110010000000001000000000
000011101010000000001000000000
000011110111000000001000000000
000011101110110000001000000000
000010100111101100001000000000
000011101111111011010100000000
000011110011111110110010000000
000011101010111111101110000000
000010101110001111111011000000
000011101010000011111110100000
000011110010000000111111111000
000011101010000000011111110110
000010101110000000000011111101
000011101010011100001110111111
000011110010011100001110011111
000011101010011100001110000110
000010101111111100001110111000
000011101011111111111110111000
000010110011110000100011111000
000011101011111111111111111111
000011100111111111111111111111
000011111111111111111111111111