111111111111111111111111111111
111111100111111111111111110011
111111000011111111111111100001
000000000000000000000000000001
000000000000000000000000000011
000000000000000000000000000111
000000000000000000000000000111
000000000000000000000000000111
000000000000000000000010000111
000000000000000000001111000111
000000000000000000011111000111
000000000000000001110011000111
000000000000000011001011000111
000000000000000111100111000111
000000000000000111010111000111
000000000000000011101011000111
000000000000000001110011000111
000000000000000000011111000111
000000000000000000001111000111
000000000000000000000010000111
000000000000000000000000000111
000000000000000000000000000111
000000000000000000000000000111
000000000000000000000000000111
000000000000000000000000000111
000000000000000000000000000011
000000000000000000000000000001
111111000011111111111111100001
111111100111111111111111110011
111111111111111111111111111111