111111111111111111111111111111
111111111111111100000011111111
111111111111111000000001111111
111111111111110000000000111111
111111111111100000001000011111
111111111111100000111100011111
111111111111001111111111001111
011011011011010000110000101111
011011011011011111111111101111
011011011011011100110011101111
011011011011011100110011101111
011011011011011111111111101111
011011011011011111111111101111
011011011011011111111111101111
011011011011101110000111011111
000000000011101111111111011111
111000011111110111111110111111
111100111111111011111101111111
111100111111111000000001111111
111100111111111011111101111111
111000011000000011111100000001
110111011011001101111011001110
001111010111001110000111001110
110000010111001111111111001110
110100101111001111111111001111
101100101111000000000000001111
101100011111000000000000001111
011100111111000000000000001111
011000111111000000000000001111
100100111111000000000000001111