000011111111111111111111111111
000001111111111111111111111111
000001111111111111111111111111
000001111111111111111111111111
000000111111111111111111111111
000000111111111111111111111111
000000011111111111111111111111
000000011111111111111111111111
000000001111111111111111111111
000000001111111111111111111111
000000000100111111111111111111
000000110000011111000000111111
000011111010000000001110111100
100111111000111111011110000001
101111111101111111000000111100
101111111110111111111111111111
110111111101111111111111111111
111011111000111111111111111111
111011100000111111111111111111
111100000000011111111111111111
111111000000011111111111111111
111111000011101111111110000111
111111100111110111100000000111
111111101111111000000000000111
111111110110000000000000011111
111111110000000000000001111111
111111110000000000000111111111
111111111000000000011111111111
111111111000000001111111111111
000000000001111111111110000000