000000000000001100000000000000
010000000000011110000000000000
111000000000111111000000000000
111000000001111111100000000000
111100000011101101110000000000
111100000111001100111000000000
111100001110001100011100000000
111000011100001100001110000001
100000111000001100000111000011
111001110000001100000011100111
111011111111111111111111110111
110111111111111111111111111011
101110001100001100001100011111
111100001100001100001100001011
101000001100001100001100000011
110000001100001100001100000011
101111111111111111111111111111
101111111111111111111111111011
101111111111111111111111111011
111011111111111111111111111101
110111111111111111111111111011
111010010011000001000001111011
111010010011000001000001110111
111010010011000001000001101111
111010010011111111111111101111
111010010011011010111010011111
111010010001100101010101111111
111011111110111111101111111111
110000000001111111111111111111
000000000000111111111111111111