000000000000001111100000000000
000000000000001101110000000000
000000000001111000110000000000
000000000011001100010000000000
000000000010001111101000000000
000000000110001011111100000000
000000001100001110001001111000
001111101000011100111111111110
011111111101110001100011111111
111111111111000001000011111111
111111111100000010011011111111
111111111110011100100011111111
111111111111110001100111111111
111111111110000011000111111111
111111111111011110000111111111
111111111111111110000111111111
111111111110000111111111111110
011111111100000100001111111110
011111111000000100011111111100
001111110000000100011111111000
000111100000000100111111110000
000111100000000100111111000000
000011111000000100111110000000
000001111111000101111110000000
000000111111110101111100000000
000000001111111101111000000000
000000000011111101110000000000
000000000001111111100000000000
000000000000011111000000000000
000000000000001110000000000000