111111111111111111111111111111
000001110111100000001111000111
000011111111110000111111101111
000110011111011001111001111111
000000001101001001110011111001
000011001101001001100111111101
010011001100001001001111111111
010111001100000000011100110111
011011001100000000011000110011
010011001000000000010000110011
010001111111111111000001000101
011101111111111110000011111101
010011111111111100000010001011
011111000100000000000011111011
010011001000000000000010001011
011111011111111111111111111111
010011110100000000000010001001
011111101011111111111111111001
010011010000000001111010001001
000110101111111110010000000011
001101000000001100011011000111
011010001110011000000000001111
110110011001110010011110011111
101100000010000000000000111101
111111111111111111111111111001
111111111111111111111111110001
000000000000000000000000000001
000000000000000000000000000001
111111111111111111111111111111
111111111111111111111111111111