110111110110011111100111111111
011011111100111111110001010111
110110000001101100111001111011
101000000001101100011010101101
010000000011000111001101011011
111100000011000001101100101101
010000000111100000101100110111
100000001000110000011100001011
000000011111111000011100000011
000000011000011000001100000011
000000001111110000010110000111
000000000000000000010110111111
000000000000000000001101111111
000000000000000000110111111111
000000000000000111110111111111
000000000000111111110111111111
000000000111111111100011111111
000000111111111111111111111111
000111111111111111110111111111
111111111111111111110111111111
111111111111111111110111111111
111111111111111111110111111111
111111111111111111110111111111
111111111111111111110111111111
111111111111111111100011111111
111111111111111111111111111111
111111111111111111110111111111
111111111111111111110111111111
111111111111111111110111111111
111111111111111111110111111111