111111110110001111111111110001
111111110111110001111111110001
111100110111111110001111111011
110001111011111011110001111111
100011111011111111111110011111
100011111011111111111111101111
100011111101111111011111010001
100011111101111111111111101110
110001111101110111111111001100
111100111110111111110101100111
111111111110111111111010110010
111111111111011111110001111001
111111111111011111100000100110
111111101111011101000000000111
111111000111101110000000001010
011111000111101100001100001101
001111101111110000011100000011
001111111111111110001000000010
011111111111111111000000000010
111111111111111111100000100010
111111100000111111000001101101
111111000000011111000111010010
111110000000001111111100101101
111110000000001111111101101011
111110000000001011111111011011
111110000111111011111100001001
111110000100001010000010101111
111111000100000011111101010011
111111100010000011111100000111
111111111111000011111110101111