111111111111111100001111100000
111111111111111011111111110000
111111111100000110110111111000
111111111010111100011111011100
111111110111111110001111101100
111111101110101111110011101100
111111100101111111011100111110
111111101110111000100110000110
111111110111100000101111000110
111111110011101010010001111100
111111101111001110000001011100
110000011001001110010101011010
101111110001100000011100011111
011001110000001111011100011010
010000110110011111100000110111
011110010110011110100000111110
011000010110011111100001110000
110000010011001111000000011000
100000011011100000000000001000
100011111011110000011000001000
110110001001111111111000011100
011100001100111111100000110110
101100000110000000000011110011
110110000011000000011110011111
110110001001111111111100000110
110111011000000000000110000101
111011110000000110000010001101
111100111000010011100011011101
111111011100011100100001111011
111111100111110111111111100111