000000000000011110000000000000
000000000011111111111101111000
000000000110011011001111101000
000000011001111100111111001000
000000111111111111011111011000
000001111111111111110111110000
000001111110001110111011111000
000010111100110111011101011110
000010111111010111011101101111
000000111100000111011101111111
000010111101110111101110111111
000101111111101101110110110111
000111111110001101110110111011
001111111111110000110110011011
011111111111111100110011011011
111111111111111110111011011011
101101100000001111111011011011
010011000000000001111011011011
011110000000000000111011011010
001100000000011000110011010110
001100000000111100100110010110
000110110011111100100110010110
000011011011111100101100010110
000001011111111100111000110110
000000011111111000110000100100
000001011101111011111000101100
000001111100110011111001101000
000000111111100110001101001000
000000010000000100000111000000
000000001111110000000010000000