000000000000000100000000000000
000000000000000110000000000000
000000000000000000000000000000
000000000000000110000000000000
000000000000000110000000000000
000000000000000110000000000000
000000001111111111111000000000
000001111001100110011111110000
000011000000000110011000011000
011111101100110110000001101110
110001101100110110011001100011
100000000000000000011000000001
100110110011000001100000000111
110110110011011001100001100111
110000000000011011001101100001
011100011110001111111100000011
000111111111011111111110111110
000111110111110110111111111000
000110110110110110110111111000
000110110110110110110110111000
000110110110110110110110111000
000110110110110110110110111000
000110110110110110110110110000
000011110110110110110110110000
000011110110110110110110110000
000011110110110110110111110000
000011111110110110110111110000
000011111110110110110111110000
000001111110110110111111100000
000000011111111111111111000000