011100000000000000000000000001
111110000000000111100110111001
111110000000001100111101101111
111110000001111000000110000011
011100000001000000011101111111
000000000000111111110000000101
000000000000000000000000001111
000000000000000000000000011001
001100000000000000000000001111
011110000000001111011100000001
110011100000011001110110000001
100000110000000000100000000011
000011011100000000000000000111
001001100110000000000000001101
001101111111000000000000111001
011111111111110000000011100001
111111111011111000000110000011
111111000001111110011100100111
111100000010111111110001101111
110001110111011111000011001111
000011100111101100111111001111
001111100111111111111111001111
011111101111111111111111011111
111111101111111111111110011111
111111111111111111111110111111
111111111111111111111111111111
111111111111111111111111111111
111111111111111111111111111111
111111111111111111111111111111
111111111111111111111111111111