000000000000000000000000000000
000000000111110011111100000000
000000001111111111111110000000
000000011111111111111110000000
000000011111111111111110000000
000000011111111111111110000000
000000001111111111111110000000
000000001111111111111100000000
000000000111111111111100000000
001111100011111111111001111110
011111110011111111110011111111
011111111101111111100111111111
011111111110111111011111111111
011111111111011111111111111111
001111111111111111111111111110
001111111111111111111111111110
001111111111111111111111111100
011111111111111111111111111110
011111111111111100111111111111
011111111111101100011111111111
011111111111001100001111111111
001111111100001100000111111111
000111111000001110000011111110
000000000000001110000000111100
000000000000001110000000000000
000000000000001110000000000000
000000000000001110000000000000
000000000000001110000000000000
000000000000001110000000000000
000000000000001110000000000000