111111111111111111111111111111
111111100100110111111111111111
110000001101100000011000000011
111100001011000000011000000011
111100011011100000011000000011
110110010111110000010000000011
110110011100111000010000110011
110000111110010100000011111011
100000111111010100001111100011
111000111111111110000000000011
111001111001111110000000000011
100001111000111011000011111111
100001111000111001000111110011
111011111011111101000000000011
110011011011111101100000000011
100110111001111001110000000011
101100001000111110011000000011
101000000111000011001100000001
101001000000000000111111111111
101001100001100000001110000111
101110110001000001110000000001
100111111000000001100011111001
110001111100000000001110000011
110000011111000001111111111111
110000000111111111100000000001
110000000110001100000000000011
110000001111111111000000000011
110000011111001111100000000011
111111011001110011111111011111
111111110111111101111111111111