000000000000000000000000000000
001111111111111111111111111111
001000000000000000000100000001
001100000000000000000111111111
001100000000000000000100000001
001100000000000000000110000001
001111111111111111111110000001
001111111111111111111110000001
000000111111111000000110000001
001111111111111111100110000001
111110000000000111000110000001
100001000000011110000110000001
000001111111111000000110000001
000001111111111100000110000001
000111000000001111000111111101
111100000000000111110111111111
110000000000000000111101010101
110000000000000000111101010101
111111111111111111111100010001
111011101011101110111100000001
110101110111011101111101111101
111011101110111011111111111101
011111111111111111110101000001
001111111111111111100110100001
000011111111111110000101010001
111111111111111111111110101001
100000000000010101010101010101
100000000000001010101010101011
111111111111111111111111111111
000000000000000000000000000000