111111111111101111111111111111
100000000011011110000000000001
100000000110110011000000000001
100000001111110001100000000001
100000011110101100100100000001
100000011111001110111110000001
100000011111101000111110000001
100000111111101000111110000001
100000111111101000111000000001
100000111111101000111100000001
100001111111101000011100000001
100001111111101000010110000001
100001111111101000010110000001
100011111111101000010011000001
100011111111101000010001000001
100111111111101000011101100001
100111111111101000111000110001
100111111111101011110000010001
101111111111101111000000011001
101111111111101100000000001001
101111111111100000110000001101
100111111111101111110000011111
100011111111101110000001111001
100001111111101110000111100001
100000111111101110011110000001
100000011111100001111000000001
100000001111100111100000000001
100000000111101111000000000001
100000000011111100000000000001
111111111110110111111111111111