000001100000000000000011110000
000011110000000000000111111000
000011111000000000001111111100
000111111100000000011111111110
000111111110110100111110111111
000111111111111111111100111111
001111111110111111110010011111
001111111110111111111101111111
011111111110011111111110111111
111111111110111111110110100111
111111111110111111100010100011
111111111111011111000000100111
100111111111011111001100100101
111000011111001111000010101100
110111100000001111001100111000
110011100011001111010010110000
111111100100101111011010100000
111111000101101111010110110000
011111000110100000011110110000
001111000111101111011111011000
000111100111101101100000001000
000111111011011111101000001000
000011000000001111001111011000
000111001000000000001100010000
000001011110000000011000110000
000001100011111111110001100000
000000111000011011000111000000
000000001111001110111100000000
000000000111100001100110000000
000000000111111111000010000000