000111100000000000000011110000
001111000000000000000001111000
011111000000000000000001111100
111111000000000000000001111100
111110000100000000010000111110
111110000100000000010000111110
111100001100000000011000011111
111100001100000000011000011111
111110011000000000001100111110
111111110000000000000111111110
011111000000000000000001111100
001110011111100111111000111000
000111010000100100001001110000
000111010110100101101001110000
000111010110100101101011100000
000011010000100100001011000000
000011111111100111111111000000
000001100111000011100110000000
000001100111000011100110000000
000001111111111111111110000000
000011111111111111111111110000
000111111010101101011111111000
000111111111111111111111111000
000111111111001011111111110000
000111111100000000111111110000
011100111111111111111100011000
110001100110110100100111001100
100011001100100100110001000110
111010001110101100010111000010
000010000000100000010000000010