000000000000000000000000000000
000000000000000000000000000000
000000000000000000000000000000
000011111111111111111000000000
000011000110000000001110000000
000011110011000000000011000000
000011000000110011111111100000
000011000011011000000000110000
000011110111111111111111110000
000011110110111110110001000000
000011000110011110001010000000
000011000110011111111010000000
000011000110001110000100000000
000011000110000110000100000000
000011000110001111111111100000
000011000110011011111100110000
000011000110111110000111111110
000011010110110000000000011111
011111111110110000000000011011
011111000110110001111100011011
001111000110111111111111111011
000110110110111111111111111111
000010000110111111111111111110
000011000111011111111111110000
000001110011111111111111100000
000000111000111111111111110000
000000001110110000000000110000
000000000011111111111111110000
000000000000000000000000000000
000000000000000000000000000000