111111100000000000000001111111
111111111111100001111111111111
111111111111111111111111111111
111100111111111111111111111111
111100011111111111101111111111
111100001111111111000011111111
111100000111111110000101111111
111111000000111100010000111111
111110000000011000111001101111
111100000000000000111111000111
111110000001100000111111110011
111110000001000000111111011000
101111000000000001111111001100
010111100010000001111111101011
100011000010000001111111100101
111011100000000011111111110010
111011111000000011111111110001
011001111100000011111111111000
001100111000000011111111111100
000110010000001001111111111000
000011000001111100111111110000
000001101111111111111111100000
000000111111111111111111000000
000000011111111111111110000000
000000001111111111111100000000
000000000111111111111000000000
000000000011111111110000000000
000000000001111111100000000000
000000000000111111000000000000
000000000000011110000000000000