000010100000000000000000001010
000010100000000000000000001010
000010111111111111111111111010
000010000000000000000000000010
000010000000000000000000000010
000010111111111111111111111010
000010111111111111111111111010
000010100101011110000001111010
000011010000101111111110111010
000011111111010000000001011010
000111011011101111100110111010
011111111111111111111001111010
010000000000000000001111111010
010000000000000000001011111010
010000011111111000001111011010
010000010000001000001100111010
010000011111111000001101111010
010000000000000000001011111010
010000000000000000001011111010
010000011111111100001111111010
010000000000000000001110000010
010000000000000000001000000010
010000000000000000001111111010
011111111111111111111000001010
000010100000000000000000001010
000010100000111111110000001010
000010100000100000010000001010
000010100000100000010000001010
000010100000111111110000001010
000010100000000000000000001010