111111111111111111111111111111
111111100011111111111111110111
111111100001111111111111110111
100011110000111111111111101111
100000110000011111111111011111
100000011000011111111111111111
110000001000001111111100011111
111000001100001111111111111111
111100000100000111111000111111
111111000010000111100011111111
111111100011000011111111111111
111111110001000111001111111111
111111111001100110011111111111
111111111100111001111111111111
111111111100110001001111111111
111111111111111010000011111111
111111111111000100000000111111
111111111110001110000000011111
111111111001001001100000001111
111111111000111100001100000011
111111111101111110000111000001
111111111111111111000011100001
111111111111111111100000111111
111111111111111111100000011111
111111111111111111110000001111
111111111111111111111000001111
111111111111111111111100000111
111111111111111111111110000111
111111111111111111111111100111
111111111111111111111111111111