000000000111111100000000000000
000000011111111110000000000000
000000101111111110000000000000
000000100000000000000000000000
000000100000000000000000000000
000110101111111111111111111100
001110101111111111111111110100
011011101111000000000001111010
011111111110000000000000111010
111111111111111111111111111101
100000000000000000000000000001
111111111111111111111111111111
111111111111111111111111100111
001000000000100000000011111100
001111111110100000000010110100
001111111110100000000010110100
001111001110100000000010110100
001111111110100000000010110100
001111111110100000000010110100
001111111111100000000010110100
001000000000100000000010110100
001111111110100000000010110100
001111111110100000000010110100
001111001110100000000010110100
001111111110100000000010110100
001111111110100000000011110100
001111111111100000000000110100
001111111111100000000000110100
001001000000000000000000110100
001111000000000000000000111100