111111111111111111111111111111
111111111111111111111111111111
111111111110000000011111111111
111111110000111000000011111111
111111100001111100000001111111
111111000001111100001100111111
111110000001111000011110011111
111100000011110000111111001111
111000001111110000111111000111
110000011111110000111111000011
110000111111110000011111000011
110000110111111000111111100011
100001110111111111111111100001
100001111111111111111110000001
100000001111111001110000000001
100000000111111111110000000001
100000000111111111110000000001
100000001111110111110000000001
100000001111110011110000000001
110000001111110111110000000011
110000001111111111111000000011
110000001111111111111100000011
111000001111111111111100000111
111100001111111111111100001111
111110000111111111111110011111
111111000111111111111111111111
111111100111111111111111111111
111111110111111111111111111111
111111111111111111111111111111
111111111111111111111111111111