000000000011111110000000000111
110000000111100111100000001001
101101111100000011111001110001
100111001000000000111111000001
110000010000000000000110000010
011111110000000000011111111100
000000110000000000011111100000
000001110000000011111111000000
000011110000001111011111110000
000010111000001111111011111000
000110000000000000000010111100
001110111111000111111011111110
011110111110111011111011101110
011111011101111101110111100111
011111100010111110001111110111
001111011100011111110111111111
000110011000001111111110111111
000000011000001111111110001110
000000011000001111111110000000
000000010000000111101100000000
000000010000000111111100000000
000000011011101111111000000000
000000011100010000111000000000
000000011101100110011000000000
000000011101100110011000000000
000000001110000000110000000000
000000001101111111100000000000
000000000110000001100000000000
000000000111111111000000000000
000000000001111100000000000000