000000000000000000000000000000
000000000000000000000100000000
000000000000000000001110000000
000000000000000000000100000000
000111111111111111111111111000
000011111111111111111111110000
000110000000000000001001011000
001100000000000000011101001100
011000000000000000001011000110
110000000000000000000011000011
111111111111111111111111111111
110000001100000000101001010011
101110000111111000010001011001
100111000000011100000001011101
100011111000111110001101011101
101000111101100011001101010001
101100001111000101101111010001
100100011111100011001111010001
101101111000111110000011110001
111011110000011000000011100011
011110000000110001000011000110
011000000011100011000011000101
001110001110000011100111001101
110110111001100011000111011011
111011000001110011100011110111
111101110101010101101011101111
111110111010101010101011011111
111111011101010101010111011111
111111100111111111111100111111
111111111111111111111111111111