000000000000000000000000000000
000000000000000001111111100000
000000000000000011100000110000
000000000000000111000000010000
000000000000000111000000011000
000000000000001111110011001000
000000000000011111001001101100
000000000000011111110010000100
000000011111101101110011100100
000001100000111100110000000100
000011110000111111110010000100
000111010001111111110111100100
001111010011111111111010000100
001110111011111011111111100110
001111111011110011010000110110
001110111111111001100001110010
001101111101111101111111010010
001111110101111100111110000110
001111101100111111111100001100
001110101111011110000000011000
001111011111001111000001110000
001111010001000011011111000000
000111110000111001110000000000
000011110011111110010000000000
000011110111111111010000000000
000001110111000000110000000000
000001110110100001100000000000
000001111111110111000000000000
000000111111111100000000000000
000000011111110000000000000000