111111111111111111111111111111
111111111111111111111111111111
111111111111111111111110001111
111111111111111000111100110111
111011111111110010011011010001
111101111111111111000000011001
111110011111111111110001111100
111111001111111111111111111111
111111001001111111111111111111
111111100100111111111111111111
111111100011111111111111111111
111111111000001101111111111111
111111110110000011001111110111
111111111011000000100011111011
111111111001110000011111111101
111111111100011000001111111111
111111111100001110000000001111
111111111110000011000110000111
111111111110000001100011000011
111111111111000011100001100111
111111111111000111110000111111
111111111111101111111001111111
111111111111111111111111111111
111110001111111011111111110111
001100001111111101111111011011
100001100011111110111111101101
111111011000011111011111110111
111100001001001111101111111011
111111111111101111110111111101
111111111111111111111111111111