000000000000000000000000000000
011111111101110111011011111110
011111011011101110110110111100
011010111111000000111101111010
010111011100000000001111101110
011110111000000000000011011110
011111110000000000000000111110
011011011100000000000000111010
010110111100000000000000010110
011111111111100000000000001110
011111111111100000000000001110
010111111111100000000000000110
001111111111111100000000000110
011111111111111100000000000110
011111111111111000000000000110
011111111111110111100000000110
011111111111101111100000000100
011111111111011111100000001010
011111111110111111111100011100
011111111101111111111100111010
011111111011111111111101111110
011111110111111111111111011110
011111101111111111111110111010
011111101111011111111111110110
011111101110111111111101111010
011111110001111111111010110110
011111111111111111011101110110
011111111111111110110111101110
011111111111111111101111111110
000000000000000000000000000000