000000000000000000000000000000
000000000000000000000000000000
000001111111100000000000000001
000111111111111000011100000001
111111000111111111111000000001
011110000000111111110000000001
000111111000000111110000000001
000000011100001111111000000001
000001111111000111111100000001
000111111111110011111110000001
001111000011111111111110000001
011110000000011111011111000001
111111110001101111101111100001
110001111000110111101111110001
000000001111011111110111110001
000000000011110111111011110001
000000000000011011111101111001
000000000000001111111110111001
000000000000000011111110011101
000000000000000000111110001110
000000000000000000001111000011
000000000000000000001111000001
000000000000000000000111000000
000000000000000000000011000001
000000000000000000000111100001
000000000000000000000011110001
000000000000000000000000110001
000000000000000000000000110000
000000000000000000000000000000
000000000000000000000000000000