000001110000000000000011110000
000001100000110000001000110000
000011100000101000001110011000
000111100000101100001010011000
000111100000111100001011001000
001111000000111100001111001100
001111000000111100001111000110
001111000000111000001111000110
001111000000010000000100000110
001011000000000000000000000110
001111000000000001111100000110
011011000000001111111111000110
011111000000011111100001100110
011011000000011111111111100110
011101000000001111111111100110
011010000000000111111111000110
011101100000000001111110000110
011010100000000000000000000110
011101010000000000000000000111
011010100000000000000000000110
011101011000000000000000000110
011010100000000000000000000111
011101011110000000000000000101
011010101010000000000111111100
111101010101000000000111111000
101110111111100000001101101000
001111111111111111111101010111
011111101101011101111111000100
011110000010000100000000000010
001000011111111110000000111111