111111111111001111100111111111
100000000000011111110000000001
100011100000111000111000000001
100011111000110000011000000001
100011001110111111111111100001
100001000011110000000000111001
100001100011110000000000001101
100001100000110000000000011101
100001000000110000000000000100
100011000000110011111110101110
100010000000111110000000100011
100110000000111000000010000001
100100000000110000011111110011
100100001111110011110100011110
100100011000011111000100000000
101100110001111001110110000001
101000100111011000011110000001
101001101100001100011100000001
101001011000001111110000000001
101101010000000111100000000001
100101110000000000000000000001
100101100000000000000000000001
100111000000000000000000000001
100111000000000000000000000001
100111110000000000000000000001
001100011100000000000000000001
011000000110000000000000000001
110001110011000000000000000001
100111111111000000000000000001
111111111110111111111111111111