000000000000000001111001111000
000000000000000111100011101100
111100000000110110001111001100
001111111000111000011100011100
000000111110011100111000111100
000000000111001111110001111100
000000000000000111100001111000
111111110000000111100011111000
000000111111001111110111111000
000000000000011100111111110000
000000000000011000011111110000
000001111000111000111111110000
001111100001110001111111110000
011100000011100011111110110000
000000000111000111111111110000
000000000110011111111010110000
000000000111111111100011110000
000000000111111100000010110000
000000000000000000000110111000
000000000000000000000101011000
000000000000000000000111111000
000000000000000000000101011000
000000000000000000000101011000
000000000000000000001111111100
000000000000000000001011101100
000000000000000000011100011110
000000000000000000010111110110
000000000000000000010001000110
000000000000000001110111110111
000000000000000001011000001101