111100111111111111111110111111
110011001111111110110011011111
100101110111111101100001011111
101010111011111101100001000111
101101111101111101000011111000
110111001110111011000010001111
110111011111011010000110000011
111011111011101010001100000001
111101110011110010011000000001
111110111111111110010000000011
111111011110111110110000001101
111111101101110011100000011011
111111101111100000100001110111
111111110111000000111111001111
111111110011000000011100111111
111000001111000000111110111111
110111110011000001100111011111
101100000001100011101111011111
011000000011111111110010111111
010000000110011100111110111111
100000000110011101111001111111
100000011100011101110111111111
010001111000010111110111111111
011111010000110000001111111111
100000110000101111111111111111
111110100001101111111111111111
111110100001011111111111111111
111110110011011111111111111111
111111011110111111111111111111
111111100001111111111111111111