111110000000000000000000000001
111111000000000000000000000001
111111100000000000000000000001
111111110000000000000000000001
111111111000000000000000000001
111111111100000000000000000001
111111111110000000000000000001
011111111111000000000000000001
001111111111100000000000000001
000111111111110000000000011111
100011111111111000000000111111
011001111111111100000001111111
101100111111111110000001110011
010111011111111111000001110001
101010101111111101100000110001
010101010111111100110000110001
111010101011111100010000111001
000111010101100000011000011001
000001111010100000001000011101
000000001101011110001100001101
000000000011101011111100001111
000000000000111111001110001111
000000000000000000000110001111
000000000000000000111100011111
000000000000000001100000011111
000000000000000001000000111101
000000000000000001110011111101
000000000000000000111111111001
000000000000000000111111110001
000000000000000000001111000001