111111111111111111111111111111
100011011000011111111000000111
100110110000001111110000110011
101101100001100111000001111001
111011000011110010000001111101
110110000011111000000001111101
101100000011111000000000111001
111000000001100000111000000001
110000000000000001111100000001
100000000000000011111100000001
100001111000000111111100000001
100011111100001111111100000011
100111111100001111111000000111
101111111100000111110000001101
111111111000110011100000011011
101111110001111001000000110111
100111000001111100000001101101
110010000001111100000011011001
111000000000111000000110110001
111000000000000000001101100001
110000011100000000011011000001
100000111110000000110110000001
100001111110000001101100000001
100001111110000011011000000001
100011111110000110110000000001
100111111100001101100000000001
100011111000011011000000000001
111001110000110110000000000001
111100100001101100000000000001
111111111111111111111111111111