000000111100000000111100000000
000001111110000001111110000000
000001111111000011111110000000
000001101011100111010110000000
000001110110111111101110000000
000001110001011010001110000000
000000100111101111100100000000
000001111100111000111110000000
000011110000001000011111000000
000111011111111111111011100000
001110110011001011001101110000
011001110000011000001110011000
011111111100111100111111101000
111111000111111111100011111100
111100010000001000001000111100
111111111111111111111101111100
111111100000000000000111111100
011000000000000000000000111000
010001000000000000000000011000
011011001100000000110110110000
001111111000000000011111100000
000001110000000000001110000000
001111111000000000010011111000
111111111000000000010111111110
111011001000000000001001101111
111110101000000000001010111111
110001110000000000001111000111
100000100000000000000110000010
101010100000000000000010101010
111111100000000000000011111110