000001111111110000000000000000
000011111111111000000000000000
000110101110101100000000000000
001101010101010110000000000000
001110101110101110000000000000
001111111111111110000000000000
001011110101111010000000000000
001101101010110110000000000000
001110110101101110000000000000
001111011111011110000000000000
000101101110110100000000000000
000100110001100100000000000000
000101011111010100000000000000
000101101110110100000000010100
000101110001110100000000010100
000101111111110100000000011100
000101111111110100000000011100
000101111111110100000000011100
000100000000000100001110001000
000111111111111100011010001000
000100000100000100010011011000
000101010111111100011011111000
000100000111111100001101110000
000111111111111100011100000000
000011111111111000010000000000
000000001110000000011000000000
000000001110111000001000000000
000000001110111110011000000000
000000000101100011111000000000
000000000111000011100000000000