000000000001111100000000000000
000000000011111110000000000000
000000000111010111000000000000
000000001110010011100000000000
000000000000010000000000000000
111111111100010000000000000000
000010000000010001111111111111
111111111100010001101010101011
000010000000010001010101010101
000010000000010001101010101011
000010000000010001111111111111
000010000000010000000001000000
000010000111111100000001000000
000010011111111111000001000000
000011111000000011110001000000
000011100000000000111001000000
000011011111011110011001000000
000110010001010011001101000000
000110010001000001101101000000
000110010001000000101101000000
000110011111100000101101000000
000110000000100000101101000000
000110000000110001101101000000
000110000000010011001101000000
000011000000011110011101000000
000011100000000000111011100000
001111110000000001110110110000
011011111000000011111100011000
110111011111111111011100001100
111111111111111111111111111111