111101111111111011011101111111
111111011110111111111000011111
110111100111111111111101111011
111111110000011111110011111111
111111100000101111110011011111
111100000111100001111010111111
010000111110110000111100011111
100011111111111000001100001111
101111110000001110100111010011
011100001111110001110101111001
110001111111110000011000110000
100011111000000000101110011000
101111000001000000110000101000
011000010000000000000100110000
110100000100000000010001101001
100100011100000000000111101101
100001111000000000011111000011
101101110011000000000000000111
001001100001111100000000011111
010001110100111011100011111111
011001111000011111111111100000
011000111100000110011110000001
111100001111111000000000111111
101110000111111111110001101110
110111000000011111111000111111
111011111100000111011110011111
111111111111111111111101110000
111110111111010111001111100001
110111111111111111000111111001
111111111101111101111111111111