111111111111111111111111111111
100000000000000000000000000001
100000000000000000000000000001
100000000000111100000000000001
100000000001100111100000000001
100000000011111100111100000001
100000000110010111100111100001
100000001111110011111110011101
100000111001011110001111110111
100001101110001111110011111101
100011110101111001111110011001
100110011100111111001111110001
100111010011100111110011000001
100111111010111001111110000001
100111111110110111001100000001
100011111111110100110000000001
100001111111111100100000000001
100001111111111111000000000001
100111101111111100000111100001
101111010000000001111111110001
111110100000000000111111111101
111011111111100001111111111101
110111111111111101001000010001
101111111111111111001100110001
011111111111111111111111111111
111111111111111111111111111111
111111111111111111111111111111
111111111111111111111111111111
111111111111111111111111111111
111111111111111111111111111111