000000000000000011111000000000
000000000000001110011100000000
000000000001111111100111000000
000000000011100011110111100000
000000000111011110111111110000
000000000111111110011101110000
000000000111111111111110111000
000000001111101110101111111000
000000001111101100001111111000
000000011111011100000111111000
000000111010111011000101111100
000000111011111011101111101100
000000111011110111000111101110
000000111011010000000000110110
000000111111111000000000111100
000001111011101000010001111100
000001111011110000011101111000
000011101100111000000001111100
000011111110111000111111111010
000001101111011100011101101110
000001101111101011000011111100
000011110111111110111111011100
000111111111101111001111111110
000111111011110111111111110110
000111101001111011011111101110
001111111111001111101101011110
001111111111111011101011111100
001111110110111111111111111100
001111011111011111011111111000
000111111111111111111001110000