001111111111111111100000000000
001111111111111111111111111111
011111110000000000000000000000
111111100000000000000000000000
111111100000000000000000000000
111111100001111111111111111111
111111000001111111111111111111
111111100011111111111111111111
111111000011111111111111111111
111111100011111111100000000000
111111000011111111100000000000
111111100011000000110000000000
111111000011000011011000000000
111111100010000011001000000000
111111000010000011000000000000
111111100010000011111000000000
111111000010000001110000000000
111111111110000000000000000000
001111111100000001100000000000
001111111100000011110000000000
001111000100000001011000000000
001111000100000111001000000000
001111000100001111000100000000
001111100100001111000100000000
001111000100001110000100000000
001111100100001111000100000000
001111000100001111001100000000
001111100100000111111100000000
001111000100000111111000000000
001111000100000000000000000000