000000000000000111111100000000
000000000000001001100110000000
000000000000010000010011000000
000000111100011111000001000000
000001111110010001100001000000
000011111111000000100001000000
000011111011000001100001000000
000111111011100011000001000000
000011111111110110000001000000
000111110111111100000001011100
001111110111111101101001111110
001111110111111111101101011110
011111111111111111111111011111
011111101111111111111111011111
011111101111111111111111011111
011111101111111111111111111111
011111111111111111111110111111
011111011101111111111111111111
011111011101111111111101111111
011111011101111111111111111110
011111111111111111111011111110
011110111011111111111111111100
011110111111111111110111111100
011110110111111111111111111000
011110111111111111101111110000
011110101111111111101111100000
001110111111111111111110000000
001110011111111110110000000000
001110111111111100100000000000
001110111110010001110000000000