111111111111011111111011111111
111111111111011111110011111111
111111111111011111100111111111
111001111111001111000111111111
111100111110001110001111100111
111110001110001100001110001111
111111000000000000011000111111
111111000000000000000001111111
111111100001111000000011111111
000000000011111110000000011111
111000000011111111000000000000
111111000011001111000001111111
111111100011110111100111111111
111111000001110111100011111111
111110001111100011111001111111
111100111110000000111100111111
111001111000000000001111111111
111111110011000000000111111111
111111100100110000000011111111
111111101101100000000011111111
111111000011000000000001111111
111111000000000000000001111111
111111000000000000000001111111
111111000000000000000001111111
111111000000000000000001111111
111111100000000000000011111111
111111100000000000000011111111
111111110000000000000111111111
111111111000000000001111111111
111111111110000000111111111111