000000000000000000000000000000
011111000000000000000000000000
011111110000000000000000000000
111001111100000000000000000000
110000111111100000000000000000
100000001111110000000000000000
000000000011111111000000000000
000000000001111111110000000000
000000000000011111111000000000
000000000000011111111111000000
000000000000001111111111111000
000000000000001111111111111100
000000000000001111111111111100
000000000000001111111111111100
000000000000000111111111111100
000000000000000111111111111000
000000000000001111111111111000
000000000000011100000001111000
000000000000111000000001111100
000000000001110000000001101100
000000000011100000000001100110
000000000011100000000001100110
000000000011100000000001100011
000000000111110000000011000011
000000000110011000000011000011
000000001110001110000110000001
000000001100000000000110000001
000000011000000000001100000001
000000011000000000011000000011
111111111111111111111111111111