111100000111011111110001111111
111111100001110111111000001111
111110000011001111111100011111
111000000110011111011110000011
111111000000111110001110011111
111111100000100010001111001111
111100000001100000001111000011
111000000001100001101111000111
111100000001101101101111011111
111000111000101101111001001111
111000101100111111010001000011
111100111111101001000101100111
111000111110011100001111110000
000001111110001000000101111000
000011011100000000101111111100
000010000000000000011010111100
000110000000000000001100011110
001110000000000000000100011110
011010000000000000000110001111
110100000001000000010011001111
100100000100100000010001111111
100110000011110000111001001111
100010000110111000000001111111
111000011110111100000111011111
001111110010111111111100001111
000100100010111110011000011111
000111100011011111111000111111
000111100001001110010000111110
001111111001100000110000011100
001111101100111111110000010100