111111111111111100001111011100
100000000000000000011111101110
100000000111111000010000110111
100000001101011100110000101011
100000001011101110100000010101
100000011110110111111110011011
100000011011101011111110010101
100000011101110111011110011011
100000011110111111101110010101
100000001111111100110000111011
100000001011111000110000111111
100000011000011000011111111111
100011111100111110011111111110
100110101011111011001111111100
101101110111011101100111111000
111011011110101010100000000001
110101111111111101100000000001
111010101110101010110000000001
111101010111110111011000000001
101110111111111111101100000001
100111011100001111110110000001
100010111000000001111011000001
100011011000000000011101100001
100001111000000000011110110001
100010111000000000001111011001
100010111000000000000011011001
100001111000000000000011111001
100010111000000000000000000001
100011111000000000000000000001
111101110011111111111111111111