111111111111111111111111111111
111111111111111001111111111111
111111111111110011111111111111
111111111111100011111111111111
111111110000000000001111111111
111100001111100011110000111111
111011111111111111111111011111
111011111111111111111111101111
110111111111111111111111110111
101111111111111111111111111011
101111101111111111111011111011
011111000111111111110001111101
011110000011111111100000111101
011111111111111111111111111101
011111111111111111111111111101
011111111111111111111111111101
011111111111110111111111111101
101101111111100111111110011011
101110011111111111111000111011
101111000111111111110001111011
110111100001111111000011110111
111011110000000000000111101111
111100111001100001101110011111
111111001111110001111100111111
111111110111111111110011111111
111111111000011110001111111111
111111111111100001111111111111
111111111111111111111111111111
111111111111111111111111111111
111111111111111111111111111111