000000000000000000000000000110
000000000000000000000000001111
000000000000000000000001101111
000000000000000000000011110110
000000000000000000000011110000
000000011111111110000001100000
000000110000000011000000011000
000001111111111111100000111100
000011000000000000110000111100
000011000000000000110000011000
000011000011110000110000000000
000011000111111000110000000000
000011001111111100110000111111
000011011111111110110011111110
000001111111111111100111001100
000001111111111111111100011000
000011000000000000011000110000
000110000000000000001001110000
000110000000000000001101100000
001100000000000000000111100000
011100000000000000000011000000
111000000000000000000001000000
111000000000000000000001100000
110000000000000000000000100000
110000000000000000000000110000
110000000000000000000000011000
111000000000000000000000111000
111100000000000000000001110000
001111111111111111111111100000
111111111111111111111111111111