000000000000000000000000000011
010000000000000000000000011111
111100011100000000000011111101
111111111100000000011110111011
101000011100011111110001110010
000000001100010000100011100011
000000111110010010100111000111
000000110011010000101110111100
000000110011111100111101100000
000000110001110000011110000111
000000111000111111110000111111
000000111100011111111111111111
000000011110000011111111111001
000000001111000111100000000000
000000000111111111100000000001
000000000111111111111111111111
000000000111111111010000000000
000000001111111110011000000000
000000001111111100011000000000
000000011111111110001100000000
000000011111111111000110000000
000000011111111111000110000000
000000111111111111100011000000
000000111111111111100011000000
000000111111111111110011000000
000000111111111111111110000000
000000111111111111110000000000
000000000011100111000000000000
000000000001000010000000000000
000000000011000110000000000000