000000000000001100000000000000
000000011000011110000011100000
000000111000011110000111110000
000000111100011110000111110000
000000111100011110001111100000
000000111110011110011111100011
000000111110011110011111000111
000000111110011110011111001111
000000011110011110111110001111
000000011111011110111110011111
000000011111011110111110111110
000000001111111111111101111100
000000001111111111111101111000
011100001111111111111111111000
111110000111111111111111110000
111111000111111111111111100000
011111111111111111111111100000
001111111111111111111111100000
000111111111111111111111100000
000111111111111111111111100000
000011111111111111111111100000
000001111111111111111111100000
000000111111111111111111000000
000000011111111111111111000000
000000000111111111111110000000
000000000011111111111110000000
000000000011111111111110000000
000000000001111111111100000000
000000000001111111111100000000
000000000000011111110000000000