111111111111111111111111111111
100000000000000000000000000011
100000000000000000000000000111
100000000000000000000000001111
100000011111100000111111011111
100000111111110001111111111111
100001110000111011100001111111
100011100000011111000000111111
100111000000001110000001011111
101110000000000000000001101111
111100001001000000100100010111
111001001101100001101101011011
110011000100100001001001100101
100001111111111111111111000110
000111111111111111111111110010
000000011111111111111000000000
000000110011111111101100000000
100100000110111110110000000000
110100001100010100011000000000
110110001000110110001000001001
111011000000000000000000011001
111101100000000000000000110011
101110111000000000000111100111
100111000000000000000000001111
100011100000000000000000011111
100011111000001100000001111111
100111111111111111111111111111
101111111111111111111111111111
111111111111111111111111111111
111111111111111111111111111111