000000000000000000000000000000
000000000000000000000000000000
000000000000000000000000000000
000000001111111111111110000000
000000011111111111111111000000
000000011000000100000011000000
000000010000000100000001000000
000000010000000100000001000000
000000010000010101000001000000
000000010000001110000001000000
000000011111111011111111000000
000000011111000000011111000000
000000011100101010100111000000
000000011110101010101111000000
000000011110101010101111000000
000011001110101010101110011000
000110000110101010101100001100
000100000010101010101000000100
000100000010101010101000000100
000110000110101010101100001100
000111001110101010101110011100
000111111110101010101111111100
000111111110101010101111111100
000_201_202_203_204_205_206_207_208_209_2010_2011_2012_2013_2014_2015_2016_2017_2018_2019_2020_2021_2022_2023_2024_2025_2026_200
001111111111111111111111111110
000_221_222_223_224_225_226_227_228_229_2210_2211_2212_2213_2214_2215_2216_2217_2218_2219_2220_2221_2222_2223_2224_2225_2226_220
000001111000000000000011110000
000001111000000000000011110000
000000000000000000000000000000
000000000000000000000000000000