111111111111111111111111111111
110011100011000001110111111111
111001110000111000111011111111
111100111000110100011101111111
101110011100111010001110111111
110111001110011101000111011111
111011100110001110100011101111
100001100000000111100001110111
111100000000000111110000111011
111010000100000111101000011101
111101000111001111111000001111
101110100111111111111000000111
100111010011111110111111000011
100011101111100111111111100001
110011110111011100101010111001
111001110011011110000000011101
111100111111111000111110010110
101110001111110101110111000110
100111000001111001111101001011
110011100001110001111101000011
111001110001111001110011001011
111100111001010000111110001011
101110011101011000000000000111
100111001100101100000000010110
110011100110111110000000101110
111001110011011001011011011101
111100111001101110000000111001
111110011100100011111111100011
111111001110000000111111000111
111111111111111111111111111111