000001111111000000000000000000
000011111111111100000000000000
000111111111111111000000000000
000111111110111111110000000000
000111111110111111111000000000
000111111110111111111000000000
000111111110111111111100000000
000011111111111111111100000000
000011111111111111111111000000
000111111110111111111111000000
001111101110111111110111000000
011111100000011111100000000000
011111110000000011111000000000
111111111000000011111100000000
111111111000000011111110000000
111111111000000111111111000000
111111111000000111111111000000
111111111000001111111111100000
111111111000001111111111100000
111111111000001111111111110000
111111111000000111111111111000
111111111000000001111111111100
111111111000000000111111111100
111111111000000000011111011110
111111111000000000011111000111
111111111000000000011111100011
111111111000000000001111110011
111111110000000000001111111110
111111110000000000001111111111
111111110000000000001111111111