000000000000000000000000000000
000000000000000000000000000000
000000111111111111111110000000
000001100000000000000011110000
000111001111111111111001011000
001100111000000000011011001100
001101100111111100001100001110
011001001100000111110111111111
110011001000011011010110000011
100110011011110001011011101101
100100110010000111011000111111
100111100110010000011011011001
110000000001111111111111110011
011111110011000111110100000111
001000111110011110011110111101
001000011001111110011011110111
001101110011110011100000111111
000111100111110011100111101011
000011111100011111110001000110
000000000000011111111110011110
000000000000001011111111111100
000000000000001101111111111000
000000000000001010111111100000
000000000000001101011111000000
000000000000000110101110000000
000000000000000011011000000000
000000000000000001111000000000
000000000000000000111000000000
000000000000000000000000000000
000000000000000000000000000000