000000000000000111000000000000
000000000000001111000000000000
000000000000011100000000000000
000000000000111000000000000000
000000000001110000000000000000
000000000011100000000000000000
000000000111000000000000000000
011100001110000000000000000000
111110011110000000000000000000
111111111100000000000000000000
111111111110000000000000000000
011111111111000000000000000000
000001111111100000000000000000
000011111111110000000000000000
000111111111111000000000000000
000111001111111100000000000000
001110000011111110000000000000
001110011111111110000000000000
001100111111111111000000000000
001110111111111111100000000000
001110011100000111110000000000
000110011110000011111110000001
000110001110000001111111111101
000111001110000000011111111111
000011000111000000000001111101
000011000111000000000000001101
000000011111000000000000001111
000000111111000000000000000101
000000010010000000000000000001
000011111111110000000000000001