000000000000000000000000000000
000000000000000000000000000000
000000000000011110000000000000
000000000001111111100000000000
000000000001111111110000000000
000000000011111111100000000000
000000000111111111100000000000
000000000011111111100000000000
000000000011111111000000000000
000000000011111111100000000000
000000000011111100111000000000
000000000001111110010000000000
000000000001111111000000000000
010000011000111111001100000110
011100111100011111101111011110
011111111110111111101111111110
011111111110011111100111111110
011111111111000111110111111110
011111111111110011110111111110
011101111110111101110011011110
011000011100011101111010001110
000010000001101000111000100000
000111100011111100111001110000
011111111001100101110011111110
011111111011100001110111111110
011111111101110001100111111110
011111111100111011001111111110
011111111110111110011111111110
011111111111011000111111111110
000000000000000000000000000000