111110011111000000011000111111
111100010001000000111101111111
000111110001111111000101000001
001111111011111110001101100001
011111111011111100011000111111
111111110001111000010000011111
111111100000111000011111111111
111111100000110000000000000001
000000100000111111111111111111
000000110001111111111111111111
000000010001111111111111111101
000001110001111111111111111001
000001000000011111111111110001
000001000000011111111111100001
000001100000111111111111000001
111111100000110000000011111111
111111000000011000000111111111
111110000000001100001111111111
111010000000000111111111111111
110010000000000111111111111111
100011000000001111111111111111
000001111111111111111111111111
000000000000000111111111111111
000000000000000111111111111111
111111111111111000000000000001
111111111111110000000000000001
111111111111100000000000000001
111111111111000000000000000011
111111111110000000000000000111
111111111100000000000000001111