001111111111111111111111110000
010100000000000000000000011000
011010000000000000000000001100
010101000000000000000000000110
011010100000000000000000000011
011101111111111111111111111111
011111000000000000000000000001
011110000111111111111111110001
011110001100000000000000011001
011110001101100000000000111101
011110001110111111110000110101
011110001110000000001000110101
011110001111111111110000110101
011110001111111111100000111101
011110001100000111100000111001
011110001100001000010000001001
011110001100010011101000001001
011110001100110111011000001001
011110001100110111111000011101
011110001100110011101000110101
011110001100111000010000110101
011110001100011111100000110101
011110001100001111000000111101
011110001111111111111111111001
011110000111111111111111110001
001011000000000000000000000001
001111111111111111111111111111
000001111111111111111111111110
000001110100000000000000111010
000000111000000000000000011100