000000000000000000000000000000
000101010101010000000000000000
111111111111111111111111111111
000101010101010000000000000000
001111111111111000000000000000
001000000000001000000000000000
001000001000001000000000111100
001001001001001000000001100100
001001001001001000000011100100
001001001001001000000011100100
001001001001001000000000000100
001001001001001000000000000100
001001001001001000000000000100
001001001001001000000000000100
001001001001001000000000000100
001001001001001000000000000100
001001001001001000000000000100
001001001001001000000000010100
001001001001001000000000011100
001001001001001000000000010100
001001001001001000000000000100
011111111111111111111111111110
011000000000000000000000000110
011000000000000000000000000110
011000000000000000000000000110
001100000000000000000000001100
000110000000000000000000011000
000010000000000000000000010000
000010111111111111111111010000
000111100000000000000001111000