000000000000000000000001100000
000000000000000000000001100000
000000000000000000000011100000
000000000000011000000011000000
000000000000001100000111000000
000000000000000110000110000000
000000000000000011001110000000
000000000000000001101100000000
000000000000000000111100000000
000000000000000000011000000000
000000000000000000111100000000
000000000000000000111110000000
001111111111100001110011000000
011111111111110001100001100000
011111100011011011100000110000
011111100011001111000000011000
011111100011000111000000001100
011111100011000110000000000110
011111111111111111000000000011
011111111111111111000000000011
011111111111111111000000000111
011111111111111111000000001111
001111111111111111000000011111
000001111111100000000010111111
011111111111111111100001111111
110011000000001100110000111110
101101111111111011010000011100
101101001001001011010000000000
110011001001001100110000000000
011111111111111111100000000000