011111110000000000111110000001
111111111000000001111100000011
111111111000000001110000000111
111111111100000001111000001111
111111111100000000111100001110
111111111100000000011110001111
111111111100000001111111000111
111111000110000011111111100011
111110000011000111110111001111
111100000001000111000010011111
011000000001100111100001011110
001000000000100011110001001110
001000000000100001110011100111
001000000000100111110010100111
001100000001101111100110110111
000100000001001111000101010011
000110000011000000001111011011
000111000110000001111000101001
000101101100000011111001111101
000100111011100111111110000100
000100010111110111111111010110
000111111111111111100100111010
001111111110111111001110000011
011111111110011111010000001001
011101111100000010111001011101
011100111000000011000011100001
011100010000000001100000000111
000100010000000000111111111110
000100010000000000001111111000
111111111111111111111111111111