000000000000000000000000000000
000000000001110000000000000000
000000000111111100000000000000
000000001111111111000000000000
000000011111110001100000000000
000011111111101110111100000000
001110111111011111011111000000
111001111111011111010011110000
111111111110111111101000111100
000001111110111111101110001110
000001111110110101111111100111
000001111110111111110011110011
000001111111011111110000111111
000001111111011111100000011111
000001111111011111100000001110
000011111111011111100000001110
000011111111011111100000001100
000111111111101111000000011100
000111111111101110100000011100
011111111111101101111000111000
011111111111101101111110111000
111111111111110011111111010100
111111111111111111111111111010
111111111111111111111110111110
111111111111111111111111100110
111111111111111111111110111110
111111111111111111111111101110
111111111111111111111111111111
111111111111111111111111111111
000000000000000000000000000000