000000000000000000000000000000
000000000000000000000000000000
000011111000000000000011111000
000011101000000000000011101000
000011111111111111111111111000
000111110111001110111001111000
000111100111001110111001111000
000111101110011101110011101000
000110111110111001110111001000
000110111100111011100111011100
001100111001110011101110011100
001101111011100111011100111100
001101110011100111011100111100
001101111111111111111111111100
001101110100000000001101110100
001110110100000000001101110100
011010110100000000001010110100
011010011100000000001010101010
011010011010000000011010011010
011100011010000000011010011010
011100011010000000010100011010
111111111011111111111100011010
110000011011111111111111111010
110000011010000000000000011010
111111111010000000000000001010
110100010111111111111111111101
100100010110000000110100001101
101000001101000001101000001101
000000000000000000000000000000
000000000000000000000000000000