010000000110000000000000000000
011000000111000000000000000000
001000000111100000000000000000
001000000111110000000000000000
001100000111111000000000000000
100100000111000000000000000000
100100000100000000000000000000
110110000100000000000000000000
010010000100000000000011110000
010010000100000000001101011100
011011000100000000011010101010
001001000100000000010101010110
111001111111111111101010101011
111100110101111111110101010101
111100111011111111101010101011
111100111111111111110101010101
111100011111111111101010101010
111110011111111111110101010110
111110011111111111111010011100
111110001111111111111111110000
011111000001111111111110000000
001111000000001111111100000000
000111000000000001111000000000
000001100000000000001110000000
000000100000000000000011000000
000000110000000000000001000000
000000011000000000000001000000
000000001110000000000011000000
000000000011110000000010000000
000000000000011111111110000000