111111111111111111111111111111
100000000001111111000000000001
111000000111100011111000000001
111100011110000000011110000001
101111111000000000000111000001
100111100000000011111111000001
100110000000011111111111000001
101100000000111111111111000001
101100000001111111111111000001
111000000111110101011111000001
111000000110101010101011000001
110000001111010101010110000001
110000011011101010101110000001
100000110101110101011100000001
100001111010111010111000000001
100001110101011101110000000001
100011101010101111100000000001
100111110101010111000000000001
100111111010101111100000000001
110111110101011101110000000001
111111111010111000111000000001
111111111101110000011100000001
101111111111100000001110001101
100111111110000000000111001111
100000000000000000000011100111
100000000000000000000001110011
100000000000000000000000111011
100000000000000000000000011111
100000000000000000000000001111
111111111111111111111111111111