000000000000011111000000000000
000000000000111111000000000000
000000000000111111110000000000
000000000000111111111000000000
000000000000111111011100000000
000000000000011111100000000000
000000000000000111111000000000
000000000000000111111100000000
000000000000011111111111000000
000000000000111111111111100000
000000000011111111111111110000
000000001111111111111111111000
000000011111111110011111111100
000011111011111100000111111100
000111000111110000000011111110
000110011111100000000011111110
000011111000001111111111111111
000111000000011111111111111111
000111000000011111111111111111
000000000000001111111111111111
000000000000011111110111111111
000000000000111101111011111111
000000000011111000111000011111
000000000111110000011100000000
000011111111000000001110000000
011111111100000000000111000000
011110111000000000001111000000
000111010000000000111111000000
000001111000000001011011000000
000000011000000001111111100000