111111100000000000000000001111
100000110000000111111110011001
100000011100001100000011110001
100000000110011000000001100001
100000000011010000000001100001
110000000001110000000000100001
110000000000110000011110100011
010000000000010000110111100010
011000000000010011100011000110
001100000000011010000010000100
100100000000001110000110000101
100110000000000111001100001101
100011000000111101111000011001
100001000001100000001000110001
100001000001000111011100100001
100011000011001101110110100001
100010000010011000100010110001
100010011110010000100010010001
100010110100110000100011110001
100011100101110101100110000000
000111111101110101001011011110
011111111001110101011001111111
111111111011111100011101111111
110011100011111100111100111111
100000111111111100111110011011
000000111111111100111111001000
000001111111111100111111111000
000001111111111000111111110000
000001111110111000111111111000
000001110000111001111001111000