111000011111100110011101110111
110010001111101110001110111011
110011000111001011001110111011
110011100011001001001110111011
110011110001001001001110111011
110010111001001011001110111011
110010011001001011001110111011
110010001001001110011101110111
110010011011001110011101111011
100010000011001100111011111101
001110001110011000111000001110
011110011100111001110111110111
011110011001111001111111111011
001100111011101000111111111101
000000110011101000001110001110
100001100111001111000110000111
111111100111011111100110100011
111111100111011101100110110001
011111100111011100110110111000
100011100111011100110110111100
111011100011001110110110101110
111101110011000010110110100110
011101110001100010100110100010
101110111000111011001100100110
110111011110001110011000100000
110111011100000010110011100001
101110111001110010110111100111
101110111001110110110111100111
101110111001001100110011001111
101110111001111001111000001111