000011111111100001111110000000
000110010000110011010011000000
011100111101011111000101111100
110100100110001001010100011110
100010001111011100011110100011
101111110100010011110000111101
100010011110110110000111101001
100111001011011111111100101011
110100111001001100001000010110
011111010101001001011111011100
000001100111101111110010110000
000000111100101000011111100000
000000000000101000000000000000
000000000011101111000000000000
000000000111111111110000000000
000000001111111111111000000000
000000011001111011011000000000
000000010000110010001100000000
000000110001110011000110000000
000000100011111001100110000000
000000100011011000110011000000
000001100110011100011001100000
000001100110001110001100110000
000011101110000111000110011000
000111001110000111100011001110
001111011011000110110001100111
011011010011001100110001110001
110111010111001100111000011001
100111010111001000101100110001
111111111111111111111111111111