000000000000000000000000000000
000000000000000000000000000000
111111111111111111111111111111
100000000000000000000000000001
100000000000000000000000000001
100011100000010000000000001001
100010001010111010100111001001
100011000100010011001001001001
100010000100010010001011000001
100011101010001010000101001001
100000000000000000000000000001
101111111111111111111111111101
101111111111111111111111111101
100000000000000000000000000001
100000000000000100000000000001
100111111111100100111111111001
100000000000000100111111000001
100111111111100100111111111001
100000000000000100111111000001
100111111111100100100011111001
100111001110000100100011001001
100111001111100100111111111001
100111111110000100000000000001
100101100011100100111111111001
100101100010000100000000000001
100111111111100100111111111001
100000000000000100000000000001
110111111111101110111111111011
111111111111111111111111111111
000000000000000000000000000000