111111111111111111111000111111
111111111111111110001000100011
111111111111111000000101000001
111111110000111100000111000001
111000011000011100000111100001
111000011000011110000011111111
111000001000111111001111011111
111000001001101111100010000111
111111111110000111000010000111
111000011110000010000010000111
111000001011100010000111101111
110000010000110111000111111111
110000010000011111101111111111
111000010000011110000110011111
111111110000011100000010001111
111111111000111100000010001111
111111111111111111000010001111
111111111111111000110110011111
111100001110011000011110001111
111100000100001000001100000111
111000000100001100111000000111
111000000100001111000100000111
111100000100111110000100000111
110111111111000110000010001111
100000011110000010000011111111
100000011110000111000011111111
110000110010000111111111111111
111111000011011111111111111111
111111000011111111111111111111
111111000011111111111111111111