111111111111111111111111111111
111111111111111111111111111111
111111110011111111111111111111
111111100001111100000111111111
111111100000111000000001111111
111111100000110000000000111111
111111110000100000000000111111
111000011000100001100000111111
110000001100100001000000111111
100000000110100001000000111111
100000000011100011000001111111
100001110000110010000001111111
100000011000111110000111111111
110000001101111111001111111111
111000000111111111111000001111
111100000011110011100000000111
111111100111100001111111000111
111111111111100001100011100111
111111110011110011100000001111
111111000001111111111100011111
111110000011111111101111111111
111100000110011111000111111111
111100001100001101000011111111
111100000000011101100001111111
111110000000110100110000111111
111111000011100100010000111111
111111111100000100000000111111
111111111000000110000001111111
111111111000000111000011111111
111111111110001111111111111111