111111111111111111111111111111
111111100001111111111111111111
111111110000011111111111111111
111111111100011111110001111111
110011111110001111100000111111
100001111111001000000000111111
100111111111101000000000000011
111111111111101000001110000001
111111111000111100011111000001
111110010000011110001111000001
111100000000011110000000000011
111000000000000010000000001111
111000001111000001000100011111
111000001111000001110111111111
111111001111000001100111000111
111111000000000111100111000011
111111000000000100000101110011
110011100110001000111100011001
110001111111110011111111011001
110001101111111100000000111111
110011101111110000000000001111
110111001001000001111111100111
111110010010000111111111110011
111000011100001001111111111011
110000111100011000111111111111
100011111001111100111111111111
100011100000001110011111111111
100111000001111111011111111111
101110000111111111111111111111
111111111111111111111111111111