111111100011111111111100011111
100000001111111111111111000001
111110011111111111111111100111
100000111111111111111111110001
111001111111111111111111111011
100011111111111111111111111001
110111111111111111111111111101
100111111111111111111111111101
101111111111111111111111111101
101111111111111111111111111111
101111111111111111111111111111
111111111111100011111111111111
111111111111111100001111111111
111111111111011100001101111111
111111111110000000011111111101
101111111110000000110111111101
101111111111000000100011111001
100111111111000001100011110001
110011111111000000000011100111
100011111111001111100111100001
101111111111000101101111110111
101111111111100111011111110001
100111111110110000111111100111
100011111100011001111111000001
111001111100001111111110011111
100000011000001111110000000001
111100001000001111000111111111
100001111000001000000000000001
100111010000001100001111111111
111100011000001111100000000011