111111000000000000000000000001
111110000000000000001000100000
111100001100000110001100111100
111100011110001111000111111111
111100011110011111100011111111
111100111111011111100011111111
111100110011011011100011111111
111100111011011001100011111111
111100111011010101100011111111
111110110011010101100011111111
111100110010011001100011111111
100000111110011111000011111111
000000011100001110000001111111
000000000011110000000000011111
000000000011110000111000001111
000110000011000001111000001111
000111000000000111110000001111
000111100000011111110000001111
000011111111111111100000111111
000011111111111111000011111111
000001111111111110000111111111
000001111111111100000111111111
000000111111111000000111111111
100000111111110000001111111111
110000011111100000001111111111
111000001110000000001111111111
111100000000000000001111111111
111100000000000000000000111111
111000000000000000000000001111
110000000000000000000000000111