111011101110111011101110011110
101110111011101110111100111111
111011101110111011101100111111
111111111111111111111100111011
101110111011101110111000110011
111011101110111010000001110001
101110111011100000000001010011
111111111111000001111111010010
111011101110011111110111110000
101110111000111111111001100001
111011101001110010111100110011
111111111001111100001100110010
101110111100110111101100111011
111011101100110110100001111001
101110110001111100100010010011
111111100011111111100011010010
111011001110111111000110110111
101110011111101110000101100101
111000110111000110100111100111
111001100011110111101101000010
100011000011111111001001100111
110011000001111011001111100101
110011000000000011001100100111
100111100000000011011110100010
001111110000000111111101101111
011111111111111111100111001101
111000011111111111000000011111
110110000111111100001101011010
110010000000000000111111111111
011110000000000011010110101101