000000000000000000000000000000
000000000000011100000000000000
000000000000111110000000000000
000000000001111110100000000000
000000000000111111100000000000
000000010000111110000000001100
000000011000011111111111111100
000000011111111000000111111000
000000001111000001111000000000
000000000000100001000000000000
000000000000100001000000000000
000000000000100001000000000000
000000000000100001000000000000
000000000000110001000000000000
000000000000010000100000000000
000000000000010011110000000000
000000000011111011110000000000
000000000111111111110000000000
000000000111111111100000000000
000000000011100011100000000000
000000000011100011100000000000
000000000001100011100000000000
000000000001100011110000000000
000000000011100001111101100000
000000000111110001111111110000
111111111111111111111111111111
111111111111111111111111111111
111111111111111111111111111111
011100000000000000000000001110
011100000000000000000000001110