000000000000000000000000000000
000000000000000000000000000000
011111111111111111111111111110
011111100111110011110011100110
011000000000000000000000000110
011000000000000000000000000010
010000000111100001111100000010
010000011111110011111110000110
011000111100011111100011000110
011000111011100110011101000110
011001111010011010100101000010
010001011010000101010101000010
010001011011001010101011000110
011001011101000101001011000110
011001101101101010010110000110
011000111110110100101110000110
011000110111011001101100000010
010000011011101110011100000010
010000001101110101111000000110
011000000110111011110000000110
011000000011011111100000000110
011000000001101111000000000110
011000000000111110000000000010
011000000000001100000000000010
010000000000000000000000000110
010000000000000000000000000110
011110011110011111110011111110
011111111111111111111111111110
000000000000000000000000000000
000000000000000000000000000000