111111111111111111111111111111
000000000011000001100000000001
000000000011000001100000000001
000000000110000011000000000001
000000000110000011000000000001
000000001100000011000000000001
000000001100000011000000000001
000000011000000110000000000001
000000011000000110000000000001
000000110000000110000000000001
000000110000000110000000000000
000001100000000110000000111111
000001100000001100000000110111
000011000000001100000001110100
000011000000001100000111101101
000110000000001100000101011001
000110000000011000001110010001
001100000000011000001100110001
001100000000111100011101100001
011000000001111100111001000001
111000000001101101110011000001
111100000001111111100010000001
101100000001011110000110000001
111100011101010100001100000001
111111110111011100011000000001
001110100011010000110000000001
000011100011010001100000000001
000000110111100011000000000001
000000011111001110000000000001
000000000011111000000000000001