000000000000000000000000000000
000000111100000000011111000000
000011111111000001111111110000
001111000001100011000000011100
011100011100110110011111001110
111001111110011110111111100110
110011111111001101111111110011
100111111111101011111111111001
101111111111111111111111111101
101111111111111111111111111101
111111111111111111111111111111
111111111111111111111111111111
111111111111111111111111111111
111111111111111111111111111111
111111111111111111111111111111
011111111111111111111111111110
001111111111111111111111111100
000111111111111111111111111000
000011111111111111111111110000
000001111111111111111111100000
000000111111111111111111000000
000000011111111111111110000000
000000001111111111111100000000
000000000111111111111000000000
000000000011111111110000000000
000000000001111111100000000000
000000000000111111000000000000
000000000000011110000000000000
000000000000001100000000000000
000000000000000000000000000000