100000000011000000000000000110
110011000111100000000110001111
110111100111100011001111001111
100111100011000111101111000110
110011000111100111100110001111
111111101111110011001111011111
111001111001111111110011110011
110000110000110011100001100001
110000110000100001100001100001
111001111001100001110011110011
110000110001110011110001100001
100000010000000001000000000001
100000000000000000000000000001
100000000000111100000000000001
100000000001100110000000000001
100000000001000010000000000001
100000000001000010000000000001
100000000001000010000000000001
100000000001100110000000000001
100000000000100100000000000001
100000000001100110000000000001
100000001111000011100000000001
100000011000000000110000000001
100000010000000000011000000001
100000110000000000001000000001
100000100000000000001000000001
100000100000000000001100000001
100000100000000000000100000001
100000100000000000000100000001
111111100000000000000111111111