000000000011000000000000000000
000000000111100000000000000000
000000000100100000000000000000
000000001100111110000000000000
000000111010110011110000000000
000011101111110111011110000000
000110011101111100111111111000
000100111111010000000001111100
001111010000010000000000111100
001010010000010000000000001000
001010010000111000000000000000
001110011111111110000000000000
001100011111111001110000000000
001100011001100000001000000000
000000001001111110001100000000
000000001100100001110100000000
000111111110111111111111111100
000111111110111111111111111100
000111111110111111111111111100
000011000010110000000000011000
000011000011110000000000011000
000011000001011000000000011000
000011000000111000000000011000
000011000000111000000000011000
000011000000111000000000011000
000011000000000000000000011000
000011000000000000000000011000
000011000000000000000000011000
000011000000111110111111011000
000011011111111111111111111100