000000000000000000000000000000
000000000000000000000000000000
000000000000000000000000000000
000000111111111111111111000000
000001111111111111111111100000
000011111111111111111111110000
000111100111111111110011111000
001111001111111111111111111100
001110011111111111111111011100
000111111111000000011110111000
000111111111000000001100111000
000011111111111111000001110000
000001111111111111110011100000
000001110111111111111011100000
000000111001111111111111000000
000000011100000001111110000000
000000011100110001111110000000
000000001111111011111100000000
000000001111111111111100000000
000000000111111111111000000000
000000000011111111110000000000
000000000011100001110000000000
000000000001110011100000000000
000000000000110011000000000000
000000000000111111000000000000
000000000000011110000000000000
000000000000001100000000000000
000000000000000000000000000000
000000000000000000000000000000
000000000000000000000000000000