111111111111111111111111111111
111111111111111111111111111111
111111111111111110001111111111
111111111000011100000111111111
111111110000000100000111111111
111111100000000100100111111111
111111000000000000000111111111
101110000000000000100011111111
100000000000000000110011111111
110000000000000000111001111111
111000000000000001111100111111
111110000000001111111110011111
111111100010011111111111001111
111111000110000001111111100111
111111000111111101111111110011
111111100111111011111111111111
111111110010110111110011111111
111111111011001111100011111111
111111111011111111100111110011
111111111101111110010100000111
111111111101111100001001110111
111111111101111110010011111011
101111111100011111110100111111
101111111011001100000101001111
101111110111000001111011001111
100111100000011111111111000111
100000000111111111111111100111
110000001111111111111111111111
111111111111111111111111111111
111111111111111111111111111111