000000000001110000000000001110
010010101111111000000001111111
011011110111111100000000111110
001111000000000000000000010100
000100110000000000111110000000
001101011101000111111111011100
001001110001100000000000000000
001011000111000010000000001110
011110000101010010011111111111
011000001011110111001111111010
110010101110001101100111000000
110110111000000111000000001000
100100100001001111000000001100
100111110001111111100000000100
101111000001111111110000000110
111101110011110111110000000011
111000000011110111110100000101
110000000011111111111110000111
110000100011111011011111000001
110001110111111011011110000011
110000111111111111111111101011
111010111110111111101111010101
110110111110111111101111010101
111111111111111111111111110111
110111111111111111111111111111
111111111111111111111111111111
111111111111111111111111111111
111111111111111111111111111111
111111111111111111111111111111
111111111111111111111111111111