000011111100000000000000000000
000111111110000000000000000000
001111111110000000000000000000
001111111100000000000000000000
001111111110000000000000000000
011111111110000000000000000000
011111111110000000000000000000
011111111110000000000000000000
111111111110000000000000000000
111111110000000000000000000000
111111110001111000000000000000
111111111011111100000000000000
111111111111111100000000000000
011111101111111100000000000000
001111110111111110000000000000
001111111011111001000000000000
001111111011100110100000000000
001111111101000110110000000000
001110111101111110001000000000
000111011110100001101100000000
000111011111111101100110000000
000111101111000011101010000000
000111110111111111111010000000
000011111000111100110111000000
000001111111000010001111110000
000001111111011000111111111110
000011111110111010111111111111
000011111110111010111111111111
000011111110100110111111111111
000011111110001001111111111111