000000111110000000000000000000
000001111111000000000000000000
000001111111000000000000000000
000001111111000000000000000000
000001111111000000000000000000
000000111110000000000000000000
000000000000000000000000000000
011111111111111000000000000000
111111111111111100000000000000
111111111111111110000000000000
111011111111101111111111000000
111011111111100111111111100000
111011111111100011111111000000
111011111111100000000000000000
111011111111100000000000000000
111011111111100000000011000000
111011111111100110000111100011
010011111111100110000011000011
000011111111100110001100000011
000011111111100110011110000011
000011110111100011001100000110
000011110111100011000000000110
000011110111100011000111000110
000011110111100001100111001100
000011110111100001100000001100
000011110111100001100000001100
000011110111100000110000011000
000011110111100000110000011000
000011110111100000111111111000
000001100011001111111111111111