111000000000011111111111111111
110000000111011111111111111111
100000111111111111111111111111
000001111100000011111111111111
000011110000000001111111111111
000111100000000000111111111111
011111000000001110111111111111
111110000001111111111111111111
111000000011111000000111111111
000000000111100000000011111111
000000001111000000000001111111
100000111110000000011101111111
111111111100000011111111111111
111101110000000111110000001111
111100000000001111000000000111
111110000000011110000000000011
111111000001111100000000111011
111111111111111000000111111111
111111111011100000001111100000
111111111000000000011110000000
111111111100000000111100000000
111111111110000011111000000001
111111111111111111110000001111
111111111111110111000000011111
111111111111110000000000111100
111111111111111000000001111000
111111111111111100000111110000
111111111111111111111111100000
111111111111111111101110000000
111111111111111111100000000001