000000001111111111110000000000
000000011000000001111100000000
000000110000000011111110000000
000001100000000011111111000000
000011110000000111111111110000
000111111110011111111100011000
000111111111111111111100001000
001111100111111111111100001100
011111000011111111111100000100
011111000001111111111110000110
111110000011111111111111000111
100111000111111110111111111111
100011111111111000001111111111
100011111111111000001111111111
110001111111111000001111111111
011001111111111100011111111111
001111111111111111111111111000
000000111111111111111111100000
000000110001111111100001100000
000001110000000000000001100000
000001100000000000000001100000
000001100000000000000001100000
000001100000000000000001100000
000001100000000000000001100000
000001100000000000000001100000
000000110000000000000001100000
000000110000000000000011100000
000000011100000000011111000000
000000001111111111111100000000
000000000011111111100000000000