111111111111111111111111111111
111111111111111111111111111111
110000111111100000110000010011
110001111111000001101111101011
110011111110000011011111110111
110111111100000110111101110111
111111111000001101100010110111
111111110000011011011101110111
111111100000110110111101110111
111111000001101101111101101111
111110000011011011111011011011
111100000110110111110110111011
111000001101101111101101110011
110000011011011111011011100011
110000110110111110110111000011
110000101101111101101110000011
110000111011110011011100000011
110000010111100110111000000011
110000101111001101110000000111
110001011110011011100000001111
110010111100110111000000011111
110101111000101110000000111111
110101110001011100000001111111
111101100010111000000011111011
111101100101110000000111110011
111110111011100000001111100011
111111000111000000011111000011
110111111110000000111110000011
111111111111111111111111111111
111111111111111111111111111111