111111111111111111111111111111
111111111111111111111111111111
111110000000000000000000001011
111100000000000000000000010001
111100000000000000000000010001
111100100010010010001000011111
111100100010010010001000011111
111100100010010010001000011111
111100101010010010001000011111
111100101010010010001000011111
111100110110010010001000011111
111100100010010011101110011111
111100000000000000000000011111
111110000000000000000000001111
111110000000000000000000001111
111110000000000000000000001111
111110000000000000000000001111
111110000000000000000000001111
111110000000000000000000001111
111110000000000000000000001111
111110000000000000000000001111
111110000000000000000000001111
111110000000000000000000001111
111111111111111111111100001111
100000000000000000000010001111
100000000000000000000010001111
100000000000000000000010001111
110000000000000000000001011111
111111111111111111111111111111
111111111111111111111111111111