111110010011111111100111111000
111100010111111111100101111000
111000011101110000011100110000
111000011110000000000100000000
110000011111000000000011000000
100010111110000000000001110000
111011111100000000000001111000
101111010000000000000001111100
000110100011111000111101111100
000111110000110001110011111100
000011111100000001000111111100
000001101111100000111111111110
101111100000000000001101111111
100111100000000000000001111011
111111100000000111000001111011
111111100000001111000001111111
101111100000000000001001111111
111111000000011111100001111111
111111000000110001100001111111
111111110000011111100001111111
111111110000000110000011111111
111111111000000000000011111111
111111111110000000001111111111
111111111111111111111111111111
111111111011111111111111111111
111111111001111111111111111111
111111111000111111111111111111
000001111000011111111111111111
000000000100001111111111111111
000000000100000011111111111110