000000000000000000111111000000
000000000000000001110011100000
000000000000000001100001100000
000000000000000001100001100000
111111111111111111111111111111
100000000000000000000001100001
100000000000000000000001100001
100000000000000000000001100001
100000000000000110000001100001
100000000000000110000001100001
100000000000000110000001100001
100000000000000110000001100001
100000000000000110000001100001
111111111111111111111101100001
100000000000000110000001100001
110000000000000110000001100001
110000000000000110000001100001
110000000000000110000001100001
111000000000000110000001100001
111100000000000110000001100001
011111111111111111111101100001
001111111100000110000001100001
000000011100000011000011100001
000000001110000011100011000001
000000001111000001111111000001
000000000111100000111100000001
000000000011111000000000000001
000000000000111100001110000001
000000000000001111111111111111
000000000000000111100011111110