000000000000000000000110101100
000000000000000000001101010100
000000001111101111111010111100
000000111111111111110111110000
000011111111111111111110000000
000111111111111111111000000000
000111111111111111111101111000
001111111111111111111111101110
001111111111111111111110110101
001111111111111111111110001111
011111111011001111111111000000
011111111010000111111111000000
011111100000000001111111000000
011111110000000011111111000000
011111111110011110101111000000
011110110110001010001111000000
011110000010000000000111000000
001110000010000000001110000000
010010000010000000001001000000
010011000000000000011001000000
010011100011110000111001000000
010011100000000000111001000000
001101100000000000111110000000
011101100111111000111111000000
111100100111111000101111000000
111100100000000001101111000000
111100110000000011001111000000
111100011000000110000111000000
001100001111111100000111000000
001100000000000000000110000000