000000000000000100000000000000
000001111111111111111111111100
000110000001111111111110001111
001111111111111111100001111110
000011111111111111111111110000
000000000100010001000100000000
000000001110010001000100000000
000000010001010111100100000000
000100011001010111110100000000
000100011001111100011110000000
010100011010001110110001000100
010100011010001110110001000100
010100011011001110110001000101
010100011011001110111001000101
010100011011001110111001000101
010100011011001110111001000101
010100011011001110111001000101
010100011011001110111001000101
010100011011001110111001000101
000100011011001110111001000101
000000011011001110111001000101
000000011011001110111001000101
000000011011001110111001000101
000000011011001110111001000100
000000011111001110111001000100
000000001111001111011001000000
000000000011001011111001000000
000000000011101001011111000000
000000000011101000001110000000
000000000001110000000000000000