111101111011101111011110110111
111010110000110110111010111011
110101100000111001110000001101
101011000100011001100010001111
110110001000011011000001000110
010110000100001111000101000110
010110001101001010101001000010
010110010010000011001010100110
010110001101001110100101000110
010110001010011101000010110110
011011010100110100100010010000
011111011001110110111000110110
101110111111101101011111110100
110110111001111010111011110101
111010111001111111111001100101
111110110001101111111001100011
111111110001111110011001111001
111100110001000111011001111101
111110111111001111011111100111
111111101110011111100111001111
111111110000111111110000011111
111111111001111111111001111111
111111111001111111111001111111
111111110000111111110000111111
111111110000111111110000111111
111111111001111111111001111111
111111111001111111111001111111
111111110000111111110000111111
111111100000011111100000111111
111111000000001111000000001111