000000000000000000000000000000
000111111111111111111111100000
110011111111111111111111111000
111001000000000000000000001110
111100000000000000000000000011
111100111111111111111111110001
111101111111111111111111111001
111101000000000000000000001001
111101000000000111000000001001
111101000000000111000000001001
111101000000000000000000001001
111101000000000010000000001001
111101000000000010000000001001
111101000000000010000000001001
111101000000000010000000001001
111101000000000010000000001001
111101011000000111000001101001
111101011000111111000001101001
111101011000000111000001101001
111101000000000000000000001001
111101000000000000000000001001
111101000000000000000000001001
111101000000000000000000001001
111101000000000000000000001001
011101000000000111000000001001
001101000000000111000000001001
000101000000000000000000001001
000001111111111111111111111001
000000000000000000000000000001
000000111111111111111111111111