000000000011111111110000000000
000000001111111111111100000000
000000011100001100001110000000
111000110000000000000011000111
101001100111100011111001100101
101011000100110010001100111101
101110001110011101100100011001
101100001110011111100100001101
101000001111111111111100000111
111000000000011100000000000010
010000000000011100000000000010
011011000000001100000000110110
001011110000011110000011110100
001100111100001100011111001100
111110001111111111111000011111
111111000000000000000000111111
011111100000000000000011111110
001111111100000000001111111100
000111100011111111110111111000
000111111100001100001111110000
001111111111000000111111110000
011111111111001100111111111000
111111111111011110111111111100
111111111111001100111111111110
111111111111000000111111111111
111111111111001100111111111111
111111111111011110111111111111
111111111111101101111111111111
111111111111100001111111111111
111111111111100001111111111111