000000000000000000000000011100
000000000011111111111100011100
000000001111111111111111111000
000000111111111111111111110000
000001111111111111111111100000
000001111111111111111111110000
000011111111111111111111110000
000011111111111111111111110000
000011111111111100000000010000
000111111111111000111110010000
000111111111111001000001110000
000111111111001000111110011000
000111111110110011101101101100
001111111110010000000000000110
001111111110000000000000000011
001111111111100000000000000001
011111111111110000000000000111
011111111111110000000000000100
011111111111110000000000000100
011111111111110000000001111100
111111111111110000000000001100
111111111111111000100000001000
111111111111111100110000011000
111111111111111110011111110000
111111111111111111001000000000
111111110000011111101000000000
111111100000000111101000000000
111111000000000011111000000000
111110000000000011111000000000
111110000000000011111000000000