111111111111001111111111111111
111111111110000111111111111111
111111001100000111111111111111
111000001100001111111110000001
111100000100011111111000000111
111110000100111111110000111111
100111000100111111100111000000
100001100111111111001100000000
000000110111111111010000111111
000000011110111111100011111000
000000010000111111100111000000
111111110000011111001100000000
110000110000011110011000000001
100000110000011110110000011111
000001111000011111100011110011
000011111111111111000110000011
000111111111101111001100001111
001111111111111111011000011111
111111111111110110010001111111
111111111000011110110001111111
111111110000001111110011111111
111111100000000111100011111111
111111000000000011100111111111
111111111111111011110111111111
111111111111111111110111111111
111110000000000111111111111111
111111000000000001111111111111
111111100000000000111111111111
111111110000001110011111111111
111111111001111111111111111111