000000000000000000000000000000
000000000001111111111000000000
000000000011000000001000000000
000000000110111111001100000000
000000000110011111100100000000
000000000110100000100100000000
000000000110100000100100000000
000000000110101111100100000000
000000011111111001111111000000
000000110000001101000001100000
000001100000001111110000100000
000011111111111100011111111000
000111000000001111110000001100
001111000000000100100000000110
011110000000000111100000000011
111110000000000111100000000001
111100000000000000000000000001
111100000000000111000000000001
111100000000000111000000000001
111100000000000111000000000001
111100000000111111111000000001
110100000000111111111000000001
101100000000111111111000000001
110100000000000111000000000001
101111000000000111000000000001
011111100000000111000000000011
001111110000000000000000000010
000111111111111111111111111110
000011111111111111111111111100
000000000000000000000000000000