000000000111111111111110000000
000000001110000000000011000000
000000011110000000000001000000
000000111110000000000001000000
000001111111111111111111000000
000011111110000000111110000000
000111111100000001111100000000
001111111000000011111000000000
011111110000000111110000000000
011111100000001111100000000000
011111000000011111000000000000
011110111000011110000000000000
011100101100000111000000000000
011111101111000001111000000000
011111101111111100000011000000
001011111011111111111111100000
001101111010111111111111100000
001110011010101111111111100000
001111101010101100000011100000
001111110110101100000011100000
001111111011101100000011110000
000111111100111111111111111100
000011111111011111111111111111
000001111111110000000000000001
000000111111100000000000000001
000000011111111111111111111111
000000001111100000000000000100
000000000111100000000000000100
000000000011000000000000001100
000000000001111111111111111000