111111111111111111111111111100
111111111111111101111111111110
111111111111011101111111011110
111110011011011000111111001110
111110011011011000110111010110
111110000011000000110011010101
111110000011000000100010110101
111110000000000000001110110101
111111000000000001111010111011
011111000000100011100010111111
001111000011100000000011011111
011111000111100000011111011111
110111011110000000110001011111
100011011000000001110001101111
100001010001111000000000101111
100001010011100000000000110111
110000000111000000000000010111
111000000000000000000000011011
111110000000000000001100001011
111111000000000001011000101111
111111000000000001111000100101
111111100000000000000001100110
111111100000000000001111100010
111111110000001100011001000011
111111111000000111110001100001
111111111100000000000000100001
111111111110000000000001100001
111111111111000000000000000011
111111111111110000000000000111
111111111111111100000000001111