011100000000000000000000000000
111110000000000000000000000000
110110000000000000000000000000
001110000000000000000000000000
000110000000000000000000000000
000110011111111111110000000000
000110111111111111110000000000
000111100110000000111100000000
000111100110000000111111111111
000111100110000000111111111101
000111100110000000111111111111
000001100110000000111100000000
000001100110000000111100000000
000001100110000000111100000000
000001100110000000111100000000
000001100110000000111100000000
000001100111111111111100000000
000001100111111111111100000000
000001010111111111110000000000
000001010110000000110000000000
000001001111111111110000000000
000001000110000000110000000000
000001000100000000000000000000
000001000100000000000000000000
000001000100000000000000000000
000011000110000000000000000000
001110000011111111111000000000
001000000000000000001000000000
001000000000000000001000000000
111111111111111111111111111111