111111111111111111111111111111
111111100011111111111111111111
111111000001111111111111111111
111111100001111111111111111111
111111110000111111111111111111
111111111000000111111111111111
111111110000000000111111111111
111111110000000000011111111111
111111100000000010001111111111
111111000000000011001111111111
111110000100000001001111111111
111000001100000001001111111111
100000111110000001001111111111
111111111110000001111111111111
111111111100000001111111111111
111111111000000001111111111111
111111111000000000111111111111
111111110000010000111111111111
111111110000110000011111111111
111111110001111000011111111111
111111100001111100001111111111
111111100011111100001111111111
111111100011111110000111111111
001100000100000110000110000011
111111000111111110001111111111
111111111111111100111111111111
111111111111111111111111111111
111111111111111111111111111111
001100001100000110000110000011
111111111111111111111111111111