111111111111111111111111111111
000000000000000000000000000001
011100000000000000000000011111
011111000000000000000001111111
011111100000000000000011111011
011111110000000000001111111011
011111111111111111111111111011
011101111111000001111111111011
011100111110000000111110011011
011000111000000000011110000011
011111100000111100000111100111
001111100001111110000011111101
001111000001111110000001111101
001110011111111111111000111001
001100111111111111111110011001
001101111111111111111111001001
001011111111111111111111101101
001011110111111111110111100111
001111110101111111010111100111
000111111111111111111111100111
000111111111111111111111101111
000011111111111111111111001011
000001111111111111111111011001
000000111111111111111111110001
000000111111111111111111100001
000000011111111111111110000001
000000011111110111111100000001
000000011111100111111000000001
000000010011111111100000000001
000000010000000000000000000001