000000000000000000000111111000
001110000000000000001111111100
111111100000000000011111111110
111111110000000000011111111110
100111111111111111111110011110
100111111111111111111110011110
111001111111111111111001111110
111001111111111111111001111110
111111101111000111111111111100
111111000110000011111111111000
001110011100011101111111100000
001100011000011101111111110000
011000011000011001111111110000
011000000000000000111111111000
110001111110000000011111111000
110001111100000000011111111000
110001111000000000011111111000
110001110000000000011111111000
110001100000000000011111111000
111001100000000000011111110000
111111100000100000111111110000
111111110001100000111111100000
111110011111000001111111100000
111110001110000011111111100000
111111000000000111111111110000
111111110000011111111111111000
111111111111111111111111111000
111111111111111111111111111100
111111111111111111111111111111
111111111111111111111111111111