111111111111111111111111111111
100000000000000000000000000001
111000000000000000000000000001
011111000000000000000000000001
000011110001110000000000000001
000000111101111000000000000001
000000001111101111000000000001
000000000001111111100000000001
000000000000011111100000000001
000000000000001111100000000001
000000000000011100111000000001
000000000000010100001110000001
000000000000010100000011100001
000000000000110110000000111001
000000000000100010000000011111
000000000000100010000000000011
000011111111111111111111100000
000111000000000000000001110000
000111111110111111111111110000
000101000010100001100001010000
000101000010100001100001010000
000101000010100001100001010000
000101000010100001100001010000
000101111110111111111111010000
000100000000000000000000010000
000100000000000000000000010000
000100000000000000000000010000
000110000000000000000000110000
000111000000000000000001110000
000011111111111111111111100000