111111111111111111111111111111
111110000000001000000000011111
110110000000001100000000011011
110110000000001101100000011011
100010000000000111100000010001
110110000000000001011000011011
110110000000000001111000011011
111110011110000000010110011111
111110010100000000011110011111
100000010111000000000010000000
100000011010001111111111111111
100000001011101100000001111101
111110001101000111111111111111
110011000101110000000111111110
110001100110100000001101011110
111000110010111000011110111010
101101011011010000111101010110
100110101101011101111111101110
100011010111101011111111011100
100001100011101111111110111000
100000110001111111111101110000
100011111000111111111011100000
100110001100111111110111011111
101100110111111111101110011111
101000011101111111011100011011
101000010111111110111000011011
101100001101111101110000010001
100110011001110011100000011011
100011110000111111000000011011
100000000000011110000000011111