111111111110001111111111111111
111111101111011111000000111011
111111000110101110011111100001
101111101111111000110111000011
000111010111110001101100000011
101111111111100011011000000111
010111111111000110110000001101
111110111110001101100000001101
111100011100011011011100011101
111110111000110000110100110101
111101010001100001100101101101
111111100011000011001111011001
111111000110000110011110110001
100000001100001100110101100011
111111111000011001100011000111
110000000000110011000110001110
111011111101100110001100011100
101100110011001100011000111110
100110000110011000110001111101
100011011100110001100011111111
100011110001100011000111101111
100001101111010110001111000111
101011111010010100011111101111
110101001110110100111111010111
110101111110010101111111111111
101010110011010101111011111111
110101000001100101110001111101
101010100000110101111011111000
110101100000011101110101111101
111111111111111111111111111010