000000000000000000000000000000
000000000000000000000000000000
000000000000000000000000000000
000000000000001100000000000000
000000000000001100000000000000
000000000000001100000000000000
000000000000001100000000000000
000000000000001000000000000000
000000000000001100000000000000
000000000000011100000000000000
000000000000111100000000000000
000000000001110100000000000000
000000111011100110011111000000
000001111011000011011111100000
000001111100100000111111011000
000101111111110011111111011100
001100111111111011111110111100
001110011111111011111110111110
011111000011110011111001100110
011111111000000000000111110110
011111111111111001111111110110
011111111100110001111111100110
011111111000110000111111101110
011111000001110000011111111100
011111111111100000001111111100
011111111111000000000011111000
001111111100000000000000000000
001111111000000000000000000000
000000000000000000000000000000
000000000000000000000000000000