111111100000000011111111111111
111110000000000000011111111111
111100000000000000000111111111
111000000000000000000001111111
110000000000001110000000111111
110000000000010001000000011000
100000000000010110111111110110
101111100000010110001111000110
001000110000001000000110000000
000000011000000100000110000011
000000001000001100000110000011
000000001000011001110110111001
010000001000010011111111111100
010000001000010011011111101100
010000001000010011111001111100
010000001000010000010000100000
011000011000011111110110111111
001111111000000000101111010011
000100011110011111100110011011
000110011111110000110000101111
000111111111110000111111001111
000101111111111000011110000111
001101011111111000011111000111
111001010111111100001111000011
100011010101111111111111111111
111110010101011101010111010101
111000110101011101010111010101
111111100101011111111111111111
111110001101011111111111111111
111111111011011111111111111111