000000000000000011111000000000
100000000111111111111110000000
110000000111111111111111000000
011000000011111111111111000000
001110000111111111111111110000
000111101111111111111111111000
000011111111111111111111111000
000001111111111111111111111000
000000111111111111111111111000
000000111111111111111111111100
000000111111111111111111111100
000000111111111111111111111100
000000111111111111111111111100
000000011111111111111111111100
000000000111111111100111111100
000000000011111111100011111110
000000111111111100000001111110
000011111111111111000000111110
000111111111111111110000111110
001111111111111111111000011110
011111111111111111111100001100
111111111111111111111110000100
111111111111111111111110001110
111111111111111111111111011111
111111111111111111111111011111
111111111111111111111111011111
111111111111111111111111101110
111111111111111111111111100000
111111111111111111111111110000
111111111111111111111111110000