000000000000000001000000000000
000000000000000011100000000000
000000000000000001000000000000
000000000000010010100100000000
000000000000101010101010000000
000000000001000100010001000000
000000000001000011100001000000
000000000001111110111111000000
000000000001000011100001000000
000000000011111111111111100000
000100000111111111111111110000
001110000111000000000001110000
000100000111011100011101110000
001110000111001000001001110000
010011001111000010100001111000
110111101111001010101001111000
111111101111101111111011111000
011111000111100110110011110000
001110000011110011100111100000
001010111100001111111000011110
001011010001000001000001000101
001011000101010001000101010001
011111110100010011100100010111
100000111001000111110001001111
100111011101000111110001011111
100001011111111011101111111111
100000111111100101010011111111
110001111111101101011011111111
011111111111010101010101111111
001011111111001101011001111111