011010000000000000000100110000
111101110000001001010011011000
101111111000000000101110110100
100111001000000000011001101100
000110000000001001000010000110
000110000000000000000000001010
001110000000000111111100000111
001100000000011111111110000011
011000111111111111111111000011
111011000011111111111111000011
110100111110111111011011100111
001011111110111111101111111111
010111111110111111101111111110
011111111111011111101111111100
111111111111101111011111111111
111111111111110000111111000000
101111111111111111000111000000
101111111111111111000000000000
011111111111111111100000000000
011111111110111111100000000000
011101111110111111110000000000
011110111111011111110000000000
011110111110101111111000000000
011111011110110111111000000000
011111011110111011111000000000
111111011110111101111100000000
111110011110111101111100000000
111100011110111100111110001111
111110011111011110111110110111
111110001111011110000001111111