000000000001111100000000000000
000000000011110110000000000000
000000000011100010000000000000
000000000010011010000000000000
000000000010001010000000000000
000000000001000010000000000000
000000000001111100000011111110
000000000000101000111111100010
000000000111111111111111100110
000000001111100111111110011100
000000001111011011110000000000
000000001110001011000000000000
110000001110011101000000010000
110000011111111101111001111110
101111111111111101111111000111
100000011111111101111111000111
111111111110001101111111001111
000000011111001101111101111111
000000011111111101111000001111
000000011110111101000000001111
000000011010111101000000000111
000000000011011011000000000111
000000000011011011000000000011
000000000011100111000000000001
000000000011111111000000000001
000000000011100111000000000000
000000000011100111000000000000
000000000011100111000000000000
000000000111100111100000000000
000000001111100111110000000000