000000000000000111000000000000
000011111100001111100000000000
000111001111011111110000111000
001000110011110011110011111100
010011111110111101101111111110
001111111111111101011111100110
011100011111111110111111000010
111000001111111100011110001110
110000000111111000101100011001
110000001111111001101110011101
010000011111111100011111011111
011000111111111111111111101110
100100111110000000011111110000
110101101100000000001111111000
111101011011111111110110111000
011010010111111100011010011100
000010011111111100000110001100
000100111100111100110111000100
001100111100011101110101000110
011010111111001111100101001001
011110111111111100000101001101
001100011111111100000101001111
000000001111111100000110000110
000000001110111001100100000000
000000001101111111000100000000
000000000111100001001000000000
000000110111110010001111000000
000011111011111100011111110000
000111111101111001111111111000
001111111110011111111111111100