000000000000000000000000000000
000000000000000000000000011111
000000000000000000000000111111
000000000000000000000001111111
000000000111111000000011111111
000000001111111100000111111111
000000111000000111000111111110
000001111111111111101111111101
000011111111111111111111111011
000111100111111001111111111111
001111101111111101111111111111
001111101111111101111111111110
001111101111111101111111111110
001111111100001111111111111110
001111111000000011111111111100
001111100000000001111111111000
011111000000000000111110000000
011110000000000000011110000000
111100000000000000001111000000
100110000000000000011011000000
100111100000000001111001000000
110001111000000111100011000000
111000111111111111000110000000
011100111111111111001100000000
000110011110001111011000000000
000011001100000110110000000000
000001110111111101100000000000
000000111000000011000000000000
000000001100000100000000000000
000000000111111000000000000000