000011000000000001100000000000
000111100000000011110000000000
000101110000000111010000000000
000101111000001111010000000000
000101111111111111010000000000
000101100000000111010000000000
000110000000000011010000000000
001100000000000001110000000011
011001111000111100011000000111
010010110111011010001100000111
010000111010111100000100000111
111111000111000011111111000111
010000000010000000000100000111
111111110010011111111111000111
001100001101100000011000000111
000110000111000001110000001110
000011000000000011000000001110
000000110000001111111111011100
000000001111110111111111111000
000000000100001111111111110000
000000000100011111111111111000
000000001110111111111111111000
000000111111111111111111111000
000011111111111111111111111000
000111111100111111111111111100
000111110000011110011001111110
000011100000011110001110111110
000000000000111110001110001110
000000000001111100011110011110
000000000001111000011100011100