010101000000001111000000000000
000100000000011111100000000000
010101000000011100110000010101
000100000000111110010000011111
000100000000110111000000001110
000100000000111101100000001010
000101100001111111101010101110
000101010001110111110111111111
001111010001111111010111111111
010001010001111100010111100011
110111100011000000011011111011
100001100011011011011011100001
101111100010001010001000111101
100001000010000000001000100001
100111000001001010010000111001
010001100001011111010001100010
001111110011100000111011111100
001111111111101110111111111100
001111111111001110011111111100
001111101111001010011101111100
001110011111010001011110011100
001001111111000000011111100100
001111111111100000011111111100
001111111011100000111111111000
000111110011100000111111111000
000011100011110001111101110000
000000000111110001111100000000
000000000111110001111110000000
000000000111111011111110000000
000000001111111011111111000000