000000000000011000000000000000
000000000000110100000000000000
000000000000110100000111011100
000000000001110110001000100010
000000000001110111000001110000
000000000011110011000000000000
000000000011110011100000000000
000000000111110011110000000000
000000000111110001110000000000
000000001111110001111000000000
000000001111110001111100000000
000000011111110001111100000000
000000111111110001111110000000
000001111111110001111111000000
000011111111110011111111000000
000111111111110011111111100000
011111111111110111111111110000
111111111111110000000000001000
000000000000010000001111111110
000000000011111111111111110000
111111111111111111111111000000
111111111111111111111000000000
011111111111111111100000000000
011111111111111111000000000000
001111111111111110000000000000
000111111111111101100011110000
111000001111100000011100001111
000110000000111001110000000000
000011000110000011000111110000
111100111000111110011000001111