000000001100011111110000000000
000000000110111111111000000000
000000000011110001111110000000
000001111111100000011111000000
000011111111100000000111100000
000111100001000000000011110000
001111000001100000000001111000
001110000000100000000000111100
001110000000111100000000011100
001100000000100111100000001110
001100000001110001110000001110
001100000001111100111000001110
001100000001111110011000001110
001100000011111111011100001110
001100000011111111011100000110
001110000011111111001100000110
001110000011111111101100000110
001110000001111111101100000110
001110000001111111001000000110
001111000000111111011000000110
001111000000111110010000000110
001111100000001111100000000110
000111100000000000010000000110
000011110000000000000000001110
000011111000000000000000011110
000001111100000000000000111100
000000111110000000000001111000
000000011111000000001111110000
000000001111111111111111100000
000000000111111111111110000000