000000000000000000000000000000
000000001110000111100000000000
000000011111011111110000000000
000000111111111111111000000000
000000111111111111111000000000
000000111111111111111000000000
000000111111111111111000000000
000000111111111111111000000000
000000011111111111111000000000
000000011111111111110000000000
000000001111111111100011110000
000000000111111111000111111100
000000000011111110011111111110
000000111000111100111111111111
000111111111011111111111111111
001111111111111111111111111111
011111111111111111111111111111
111111111111111111111111111110
111111111111111111111111111100
111111111111110101111111111000
111111111111110101111111111000
111111111111110110111111111100
011111111111110110111111111100
001111111111100110011111111100
000001111111100110011111111000
000001111111100110000111110000
000001111111100110000011100000
000001111111001100000000000000
000000111110011100000000000000
000000000000111000000000000000