000000000000000000000000000000
000000000000000100000000000000
000000000000001100000000000000
000000000000001100000000000000
000000000000011110000000000000
000000000000011111000000000000
000000000000111111000000000000
000000000000111111100000000000
000000000001111111110000000000
000000000011111111111000000000
000000000111111111111100000000
001111111111111111111111111110
111111111111111111111111111111
011111111110011100111111111110
001111111101101011011111111100
000111111111101111011111111000
000011111111101100111111110000
000001111111011111011111100000
000000111110111111011111000000
000000011101111011011110000000
000000011100001100111110000000
000000011111111111111110000000
000000011111111111111110000000
000000011111111111111110000000
000000011111111111111110000000
000000111111110011111110000000
000000111111100001111111000000
000000111110000000011111000000
000001111000000000000111100000
000011100000000000000001110000