000000111111111111111111111000
000000111111111111111111111000
000001111111111111111111111000
001111111111111111111111111111
001111111111111111111111111111
000011111000000000000001111100
000111110000000000000000111110
000011110111100000011110011111
000001111111100000111111011111
000111111000000000100011001111
000111110011100000011100011111
000011110100010000100010011111
000001110111111001111110011110
000000110011101000011100111110
000000110001001001001000101100
000000010000001001000000101000
000000010000011001000000101000
000000010000010001001000101000
111000011000011111001000110000
001100001000111111101101100000
000111111000111111110101111111
000100001000000000000101000001
111100001100001111000011110001
111100001110000000000110010111
111100001011000000001100011000
111100011101111111111000011100
111100111110000100000110111110
111101111011011111011101111110
111111111101111111110011111111
111111111110001110000111111111