011111111111111111111111111111
010110011000000000010000010001
010110110000000000011000010001
010110110000100000001100010011
010010100001100000001100011011
011011100011000000000110011011
011011001110000000000110001011
011001111100000000000011001111
011111100000000000000011011111
010111000000001000100001111101
010011100000001001100001111001
010001110000011001000011100001
010000111000010001000111000001
010000001110110001000110000001
010000000111100000101100000001
010000110011110000111001100001
010000111000111001110011100001
010000111110011111111111000001
010000011111111111111110000001
010000001111111111111100000001
010000000111111111111000000001
010000000001110011001000000001
010000000000110111011000000001
010000000001111111111000000001
010000000001111111111000000001
000000000001111111000100000001
000000000011111110111100000001
011111000111111110010100000001
011111111111111111001000000001
011111111111111111111001111111