000000110000000000000000000000
000111011011000000000000000000
001111101111100000000000000000
011100111011110000000011000000
011011001101111000011101101100
111011011101111000111110111110
010100111001111001110011110111
011110111111110001101100110101
011111101111011010101101101111
101111110001111011111011001011
110011100111110111110001111110
011000011111101101101101011111
001100111111001110111111000111
000111111110001111011110111110
000011110010000111100001111100
000000000010000011110011110000
000000000011010001111111110000
000000000001100000011111100000
000100000011110001111000000000
000111000000110111001110000000
000011110000111110001111000000
000011111100111111000111100000
000011111111010111100011100000
000001111101111011110000100000
000000111000111100111100000000
000000000000011010000000000000
000000000000001100000000000000
000000000000011100000000000000
000000000001011110000000000000
000000000000110111000000000000