000000000000000000000000000000
000000000000000000000000000000
000000000000000000000000000000
011111111111111001100111111110
010000000000000011110000000010
010000000000000011110000000010
010000000001111111100000000010
010000000011111100000000000010
010000000111000110000000000010
010000001110000110000000000010
010000001100000111000000000010
010000011100000011000000000010
010000011100000011100000000010
010000011001100001100000000010
010000011001110001110000000010
010000011000111000110000000010
010000011000011100011000000010
010000011000001100001000000010
010000011000001100001100000010
010000011000000110000100000000
010000110000000110000110000000
010000110000000110000011001110
010001110000000110000011001110
000011100000000110000001100000
000111000000000110000000110000
011110000000000110000000111110
011100111111110110111110011110
000000000000000000000000000000
000000000000000000000000000000
000000000000000000000000000000