000000000000000000000000000000
000000000001111111000000000000
000000000111111111111000000000
000000011101011111111110000000
000000110000110111111111100000
000000101111001101111111110000
000001011111110001100001111000
000011011110111011000000011000
000010111101111010110000001100
000110111011110110011000001100
000101110111110100001000000100
001101110111101100011110000110
001011110111101000011111100110
001011111111011000001111111000
010111111110110000001011111110
010111111110110000001000111110
011001111101100000001000001100
010110011011000000001001001010
011101100011000000011011001010
011111000110000000011110001010
011111111100000000110111011100
011111111100000000100101110100
011111111100000001001100101100
001111111110000110001000111000
001111111110011100000001110000
000111111111111000100001110000
000011111111000000000011100000
000001111111110000000111000000
000000011111111110011110000000
000000000111111111111000000000