101101110111000000011111111100
110111001100000000010000001110
110111011001110000100000000110
110101010011001000100011110110
000101010010110100010111111011
110101010010010111000100011111
111000010010001111100100001111
101111000010011000000010000111
110111110001011000000000000111
110011111101101100000000000011
111010011111100100000001111011
101001111111100110000011001110
101000101111100110011110110111
101100011011000110001110000111
110110101110001110000011000111
100011110000011100000001001111
111011011111111000000011011101
110010111111100000000110011001
100010001000011110000110011001
110110001000110011110100011110
001111011110100101110100010111
000011100110100001000100000011
111100000000110010000100000011
111111111100010011001110000111
111001110011111001100111111111
000110000110111000101001111110
110111111111110000100000011011
100001101101100000100011100000
001000111111000001111000011111
011100011110111111011111000000