000000000000000000000000000000
000000000000000000000000000000
000000000111111111110000000000
000000011111110011111100000000
000000111111000000011110000000
010000111100000000101111001000
011111111111100011010111001110
010011111111111110011011100010
010100111000001101101011101100
010110100000000101101001111010
011010001100011001011001111010
011100011010110100110011111100
001000010110101100010011111000
011000010110101100001001110000
010000001110011100001001110000
010000000000000000001000110000
010000001111110000001001110000
011000011100011000001001100000
001000011010101000011011100000
001100011000001000010011000000
000110001100011000110111000000
000011100111110001100110000000
000001111000000111001100000000
000000101111111100101000000000
000000010001001111111001111100
000000011011011011011000011110
000000001111111000000011111110
011111001110110001111111110000
000000000000000000000000000000
000000000000000000000000000000