000000000000000000000000111100
000000000000000011111001000010
000000000000001111111111111011
000000000000011111111111001101
000000000000011110011111100111
110001110000001101010011100011
101111001011100100001011000001
100000111110011110001110000000
101111111110010100011111000000
110111110111001011111111100000
000111111001100111111111100000
000111110111110000011111100000
000111110000011111110001000000
000110110000000110101111100000
000100010000001110101111100000
000100010000001110101111110000
000000000000011110101111111000
010000000000011110101111111100
010000000000111111101111100110
111000000000101110100110001110
101000000000100011110000111000
101000000000111111011111100000
111010101010000001100100110000
111111111110000000100110011000
111110000011111110111111001000
111111111110000000011101111100
110000000011111111011000111100
111111111110000000101000011110
111111111111111101111000001011
000000000000000011111000000111