001101111111111111111111111011
000101111111111111111111111011
000110111111111111111111111011
000010111111111111111111110111
000010011111111111111111110111
000011001111000011111111110111
000001000110111101111111101111
001100000001111110111111101111
001111111111011111011111011111
001111011110101111011111011111
001101010011001111011111011110
100001001001001110111110111101
110001110001100110000011000001
110001111000010100000011000011
011000111111111110000010000010
011000111111111010000010000110
001100111111111101000110000110
001100011111111101000100001100
000110000011111101000100001000
000010000111111101101100011000
000011000111111110101000010000
000001000111111110101000110000
000001111111111110111111100000
000000111111111111110111110000
000000101111111111101111010000
000000100000000000101000110000
000000110111111111111111100000
000000011111100111000111000000
000000001100111000111001000000
000000001111000111000111000000