000000000001110000000000011011
000001110011111000000000001110
000001111011110011111000000000
000000111111100110001100000000
000000011111001101000100000111
000011111111111100000100011111
000000001011111110001000110111
011111001110000011101001101110
110001101111011000101011010110
100010111010101100101111101100
100000111101010101011111011000
101010110101100101011010111111
110001110101111011011111100011
011111101101110010001111000110
000111101111110010000000000100
000011011111100011000000001100
000001111111000001100010111000
000000111110000000111111001110
000000000000000000000001111011
110000000000000000000000001100
100000000000000000000011110000
111111100000000000000010010011
111110110000000000000011011111
111100011000000000000010010011
001001001100000000000011011111
111000001000000000000010010011
111001101010101010101011011111
001001101011111111111010010011
001001101010101010101011011111
111111111111111111111110010011