000000000000001100000000011100
000000000000011000000000001110
000000000000111001111100000111
000000000000111111111111000111
000000000000111111111111101111
000000000000101110011111111111
000011000001000100001111111110
010001100001110111001111111100
011000110011011101011111110000
001100010011111111111111110000
000110110011111111111111110000
010011100011101101111111100000
011001110001110011111111000000
001101011000011111111110000000
000111001100000001111000000000
000000000111000111111100000000
000100000101101111111110000000
001100000100111101111111000000
011000000011111001111111100000
011000000000001101111101110000
111000000000000111111100110000
110010000000000011001100110000
110011100000000001110110111000
111001110000000001111111101000
111101111000000010011111001000
011100111000011110011111111000
001100111000110001111101100000
011101110000100011000100110000
111001110000110110001100011000
111011100000000111111000001000