000000000001110000000011000000
000000111101111011110111101110
000111000000111100001111000001
011000000100011110011110001111
111111111011101111111100111000
000000000000000011000010000000
000000000000000110111110001111
111000111100001111111110111001
101101110011011111000011110000
110111101000111101000011100100
010011001010111001011011010110
110101001100110001010011001010
111001000100000001000011111110
010011101101111101100011000011
111110111011111011110110001111
111111000000000111111100011111
000000111111110111111000111111
011111111100000100001111110110
111111000000000101101111110110
111100110110111101001010110000
011011000001110100001111110111
111000000011100111011111111111
110110011001110000100000000001
111000000000011111000111111001
111100111100000011111000111100
110000000011101000011100001110
101110111100000000111100111110
000000000000111001110001101101
111111110111000111001111111011
001111000000011000111111111111