011111111111000000000000000000
111111111011100000000000000000
101111111101110000000000000000
100111111110111000000000000000
010011111111111100000000000000
001000000000010000000000000000
111111111111111011101100000000
111111111100000111110110000000
111111111110001101111011000000
111111111111001000111101100000
100000000010011010011110110000
111111111111010100001111011000
000000000000010100100011101100
000000000111110101000001110110
000000001100011001010011100011
000000011000001101010011001111
000011110011000110000110011011
000010000010000011000110110110
000111001100111001100101101100
000111100000100000110111011000
000011110011000000011110110010
100001111000000111111101100101
011000111100001100110011000011
101100011110011011111110010101
111010001111110111100000011111
101111000111001111000101101111
111110100011111110001010111111
111101011001111100101111111111
111111110100111001010111111111
111111111110010011111111111111