010011100001111111110000000000
111001000111111111111100000100
010000011111111111111111001110
000000000011111111111111100100
001111110000011111111111110000
000001100000000111111111111001
000011000000000011111111111100
000110000111110001111111111100
011000000001100001111111111100
011111110011000000111111111110
000000000111110000011111111110
001111100000000000011111111110
000011000000000000011011111110
000110000000100000111001111101
001111100000011111111100111001
000000000000001111111010000011
000000000000000111110110110111
000000000000000111111110110111
010000000000011111111111111111
011100000000011111111111111111
011110000001101111111111111110
001111100001111111111111111110
001111111111111111111111111100
100011111111111111111111111100
110011111111111111111111111000
100001111111111111111111110001
000000111111111111111111100000
010100011111111111111111000010
111001000111111111111110000111
010011100000111111111000100010