000000000111111110000000000000
000000011111111111111100000000
000000111111111111111111000000
000001111111111111111111110000
011111111111111111111111111100
111111000011111111111111111110
111111100001111111111111111110
111111100011111111111111111111
111111100111111111111111111111
111111101111111111111111111111
011111001111111111111111111111
000000001111111111111111111111
000000001111011110011111111111
000000000100000011000111111111
000011110110011101000011111111
000110011110011100000001111111
000100000000011110000000111111
000100000000000000000001110001
000110000000000000000001110101
000011000011111000000001101101
000001111111111100000011100011
000000001111111110000011110110
000000011111111111000111111111
000000011011101111111111111111
000000011100011111111111111111
000000001111111111111111111111
000000000111111111111111111110
000000000111111111111111111100
000000000111111111111111111100
000000000011111111111111111000