010000000010111100000011111100
011111000011111110100101111110
010111111011100011001011001110
010000000010001000011110110110
010001000010011100010010111110
010011100010110110011110011100
010110110010111110001010000000
010111110010110101001010000000
010110101011111010001101000000
011111010011111110001101000000
011111100011000100000100100000
110110010110011010000110100000
101101101110111111000110100000
001011110101111101001110010000
001010110111001101001111010000
011011110110000111011011001000
001101101100110011110111101000
101110011101011011101111100100
110111111100110011011101110100
111110000110000110111011110010
100011000011011101110111110010
000001110001110011101110110010
001000101001001110011100110010
010100111001111001111011110110
001000110011100111100111101100
000001100110011110011111111100
100011111111111001111011111000
111111111111111111100001110011
000011100001111110001100001100
111100001110000001110011110000