001111111100000000000000000000
011111111110000000000000000000
011111111111000000000000000000
011111111111000000000000000000
011000100011000000000000000000
110000100001000000000000111111
110001110001100000000001111111
110011011001100000000011110000
111111011111100000000111100000
011111111111000000001111000000
000111111100000000011110000000
000111111100000000011110000000
000001111000000000111100000000
000000111000000000111000000000
000001110000000001110000000000
000011000000000001110000000000
000011000000000011110000000000
000011000000000111110000000000
000001000000000111100000000000
111111111100001111100000000000
100111111100001111100000000000
100111111100011111000000000000
100011111100111111000000000000
100011111111111110000000000000
110001111111111110000000000000
111001111111111100000000000000
111101111111111000000000000000
011111111111110000000000000000
001111111111100000000000000000
000011111110000000000000000000