000000000000000011110000000011
110000011110001111111000001111
111100111111011111111100011111
111111111110111111111100011111
111111101101111111111110111111
011111111111111111111111111101
111111110000000000000000001111
111111000000101110000000100001
100000000111111101000000100000
000000000000101101011111100000
000000000000111111111111110000
011111000001000000000000111000
110001111111111111010000001000
101110000000000000110000011000
110001111111111111110000110000
011111001000011111110011111100
000000111100000000001111001110
000011100111111110101110011111
000110101011111111110010111101
001100110000000000110011111011
011111100000000000101111100101
111001101000000010100001001101
110001011000000110000011010111
111111111111111111111111110111
111111111111111111111111010110
011111110000000001111111011110
010000011000000000100001011100
011111111111111111111111111000
001110001111111111110000110000
000111111000000000011111100000