000000000000000000000000000000
000000111111110000000000000000
000011110000011000000000000000
000110100000010100000000000000
001101100011111110000000000000
011011000110011010000000000000
010111100001110111000000000000
010110100000110011000000000000
001111000000011011100000000000
001111100000001010100000000000
011111100000011110100000000000
011111000000001110100000111000
011111001111111110100001101100
011111111111111110100011100110
011100000111111111000111100010
011111110001111110001111110000
011100000001111100011111110000
010000000000111100111111110000
000111111110001101111111110000
011111111000011111111111111000
000000000000000011111111111000
000011111111111000111111111000
011111110000001111111111111000
000000011111111111011111111100
000000000000000000001111111100
001111111111111000001111111100
011000011111111111111111111100
000000000000000000111111111110
011111110011111100000110000000
000000000000000000000000000000