000000000000000000000000000000
000000000011100001111000000000
000000000111100011111100000000
000000001110110111100110000000
000000011111111111111111000000
000000011111111111111111000000
000000111111111111111111100000
000001111000111110011111100000
000011110000011100000111110000
000111100110000000000011111000
011111011111001111100001111100
011111111111111111111000011110
001111111111111111111101111110
000111111111111111111111111100
000111110111111111011111111000
000011101111111110111110110000
000111011111111100111110100000
001110111111111101111111000000
001110111111111001111110000000
001110111111111011111110000000
011101111111110111111100000000
011101111111110111111100000000
011101111111100111111000000000
011101111111000111111000000000
011101111111001111110000000000
001110111111011111100000000000
001111111110011111000000000000
000011111111111100000000000000
000000111111110000000000000000
000000000000000000000000000000