000011111000000000001111111000
001110001100000000011111111100
011000000111111111111111111110
110000000000000111111111111110
100000000000000111111111111111
100000110000000111111110111101
110001100000000111111111011101
111011011110000011000011101101
111010110010000001011001101101
111110000000111110111111010101
111100000001100111011100010101
111100000001011111000111110101
111100000001111111000000010101
111100100000111110000010010101
111100100000001000000010010111
011100110000001000000110011110
000110011100011100011100110000
000010010111110111110100100000
000010010010000000100100100000
000011011011000001101101100000
000001101000111111001011000000
000000111100011100011110000000
000000010111000001110100000000
000000110001111111000110000000
000001111000000000001111000000
000001011110000000111101000000
000111011111111111111101110000
001101110111111111110111011000
011000110111011101110110001100
110000011111011101111100000110