000100000000000011111111100000
000100000000000110000000110000
000100000000001000010000011000
000100000000011000111000001000
011111000000010000010000001000
010001000000010000000000001000
011101000000011111111111111000
010001000000111111111111111100
011101000000111111111111111100
010001000000111110110111111100
011101000000110000000000011100
010001000000110011000110011100
010001000100110010000100011101
010001000111110011000110011111
010001000111110011000110011111
010001000011110000000000011111
011111000011110001000100011110
001010000001111001111100111100
111111100000111100000001111000
010001000000000111000111000000
010010000000000000111100000000
001111000000001111111111111000
000111100000111111111011111110
000111100001111111111101111111
000011110001111111111110111111
000011111011111111111111111011
000001111111111111111111111011
000001111111111111111111111011
000000111111111111111111111111
000000011111011111111111111110