000000000000000000000011111000
000000000000000000000111111100
000000000000000000001111001100
000000000000000000001110111110
000000000000000000011100111110
000000000000000000011001111110
001110000000000010011011111110
011111100011100101011111001111
011111110010100100111110110111
111100111100110100111110110111
111111001110010110111111001111
111111100111011010111011111111
111111110011101010110101111111
111100111011101000111011111111
111011011111110110111111111110
111011011110110110111111011100
111100111101011011111100110000
011111111110111111111111100000
001111111011111111101111111000
000111100111110111110111111100
000011111111101111110111101110
000000000011101111111101110110
000000000111111111111010110110
000000000111111111111101111110
000000000111101101101111111110
000000000101010101110111111100
000000000101101101110000001110
000000000110111100110000000111
000000000011111000110000000011
000000000000011000000000000000