011110011111111111101111111111
000000000000000000000111111111
001111100001101111011111111111
011111110000000000000000000011
011111111000000001111101111111
111111011000000000000000000000
111110010000000000000001110111
011110010000000000000000000000
111100010000000000000000000011
001001110111111111111000000000
001111000100100000001111000000
011101101101100000000001111100
111000111000111110011111000111
111000010011100011110000000001
111100000110000110000111000111
111110001100000100011100011111
011111011000000101110001111110
010001111100000100000111111110
010000100110011100011111111100
011000100111110001111111111000
001111110111000111111111110000
000000011100011111111111100000
000001110001111111111110000000
000111000111111111111000000000
110100111111111111100011111111
011111000011111110001000110011
000000111100111001110111111111
101110000111000111001110011100
110011110000011100111111111111
111111111111100011110001100010