011111110001110010111110011111
011111111001110010111100111111
111111111001111010111101100111
111110011100111010111111000011
111000001110111010111101000011
111000010011111011110001100010
111000010000111111000000100100
111100110000000000000000111111
000111100000000000000000011110
000011101110000000001111011111
111111001101100000011001111110
111110000111110000111110011000
111110000000010000000000001111
000010000000110000100000001111
011111000001100000110000001100
111111100011000000001000011100
110000110011000000111000111111
000011110011110001110100111111
000110111010001111000101101111
011100111111100100111111101111
110001110100000100000111100111
000011111111100100110100110011
001111110110011111001100111001
111110111011110001101111111100
111001111001100000111101011110
110111110011100001111101001111
011111110110111111101101000111
111111101100101110101110100111
111111001001101110101110110111
111111011001001110100111010010