111111111111111111111111111100
111111011111111110110111111110
111110111111111100110111111110
101110111111111010110111011111
011101111101101001110011011111
011011111001100100010011001111
111011110001100000011001100111
111111110001000110001000111111
111111100111111111100011111111
111111101111111110100011111011
111110011011000011000110001111
111110000010111101000111110111
111111111111110011011111011111
111100110011110001101111010011
111100001011000001000100000111
111110000111100011000110001111
011110000001111110000011111100
000110000000000000000011000100
110000000000000001000001000100
010000000000000001110011000100
000100000000000000011100000100
100100000000000000001000000100
111100000000000000110101000100
111100000000000111111110001100
111110000000001100000000001100
111011100000000000111100011000
111001111000000000000001111000
111000011111000000000001110000
101110000111110000000011100000
000111000001111111111111000000