000000000001111110000000000000
000000000011111111000000000000
000000000110000001100000000000
000011101110000001110000000000
000111111100000000110000000000
001111111000000000011000000000
011000111111111111111111111000
110000000000000000000000111100
110000000000011111111110000100
110011011011010010101010000110
110011011011011111111110000011
110000000000000000000000000011
011000011111111111110111111101
011000011111111111110101110101
001100010000000001110100100101
000110010000000000110111111101
000011010000000000110000000001
000001010000000000110000000001
000001110000000000110001111001
000000100000000000110010000101
000000100000000000110001111001
000000100000000000110000000001
000000100000000000110111111111
001111111100000000110000000001
111111111110000000111111111111
111111111111111111110111111111
110001111111111011111111111011
110000011111011111111111111101
111111111111111111111111111111
111111111111111111111111111111