111111110011111111111111111000
111111101111000000111111111100
111110011001100011100011000110
111100110000000110000001100011
111100111100000000111100100011
111000110100000001100110100011
110001100100000011000010110001
110001000100000010000010000111
100011001100000110000010000010
100010011100000100001110000110
000010011000000100011110000100
000010111000000100011110001100
000010111111100110111100000110
000111011000110010111100001100
110101110000011110111011111000
011111000000000111111110001100
000111111000000000011001000100
100000001100000000000001110100
111100000000000000000111010100
001111111000000000011110011100
000000101110000001111101110000
000000101111111111110011100000
000000101111000111100111100011
000000100111100111011110101111
000000100111111110111110111101
000111110111111101111100111100
011110011000111001111000001110
110001111100000011010000001110
000111111111111100010000001110
111111111011111111111000001110