000000000111111111100000000000
011111111100110000110000000000
000000000101100000010000000000
000000000111111111111110000000
000000000000011111111111000000
000000100010010000110011100000
000000110110011001110011100000
000001111110001111110011100000
000001111111000011100111110001
000011111111101111001100010011
011111101111111001011000010111
110001111111111001110000111111
100000111111110111110001111110
111100111111000110111111111000
111111111000111111011001111100
011111000111111111111000111100
011100000011111111110000111100
000000000011111111110001111000
000000000011111111111111011000
000000000011111111101110111000
000000000011111111101101111100
000000000011111111100011111110
000000000011111111111111001111
000000000001111111111111000011
000000000011111111111011100001
000000001111100111110000111101
000000111111100111100000011101
000000111100000111000000011001
000000110000000111000000000011
000000110000000110000000000111