000000000000000011111000000000
000000000000000111111100111111
111110011100000111111111111111
000000000000000111001111111111
000000000000000110000110011111
000000000000000111000110001111
000000010010000001101110001111
000000011011000000111010001111
000000011111000000000010011111
000000001111100000000010011000
000000011111111000000110010001
000000111111111111111100010011
000001110111111110010000110110
001111111111111100111111101100
001001111111111110011000001000
001000111111111111111110001001
011100111111111111111111111000
111111111001111111111111111100
011111000000111111111110111100
011100000000011111111110011110
000000000000011111111111011111
000000000000001111111111011110
000000000000000111111111001100
000000011111111111111111101000
000000000000000111111111101111
000000000000000111111111101111
000000000000000111111111110000
000000000000000111111111111111
111111111110000011111111111111
000000000000000011111111111111