000100000000000000000011110000
001100000000000000000110111000
011100001111111110000100011100
111111011000000011000100010100
000110110000000001100100010110
000100100000000000100100010010
000001101110000000110110110011
000001010000000000010011100001
000111001111111111111101110001
011101111000000000110011010001
110011000010000100011111010001
111111000001111000110001011001
000001100011001100100001001001
000000111110000100100001001101
000001110000001101100011100111
000011000011111111000110110011
001010000110001001111100010100
011011001111011010000000110110
011101111001110011111111101110
111100100000000001100001001110
111110100000000000100001011111
111110111111111111100001011111
111110111111111111100001011111
111110111111111111100001011111
111110111111111111100001011111
111110111111011111100001011111
111110010010001001000001011111
011101110010001001110001001110
001011111010001011111001000100
111011111110001111111011111111