000011101111011111110001100010
001100111001110111111011001111
111011111111111000000010001001
111110111111000000000000110001
111100111110000000000000111111
111100111110000000000000011111
111111101100000000000000011111
111111111000000000000000011111
111111010000000000000000011111
111111011111100000011110001111
111110110001110000111001001111
111111100000010000100010101111
111101011001111000000011111110
111101001111100000011111011111
111011000000000000000000001111
111111000000000000000000001111
111111000000000000000000001111
111111000000000111000000001111
111111000000001111100000001111
011111000000000111000000011111
111100100000000000000010011110
111111110000011111110000011111
011111110000111111011000011101
011111010000011000110000011111
001011111000001111100000011110
001111111100000000000000110110
000011111110000000000001101100
000000111111100000000111100000
000000000100111000011101100000
000000000100001111110001000000