000100010001100000000000000000
000100000101111111000000000000
111100011100011111101111111111
000100111111010111000000000000
000101111111111111111101111100
000100100011111111111110111111
000100000001111111111110000000
111111100111111111001111000000
000000001100111100001111100000
000000011001100000000010110000
000000000011000000000001001100
000000000100000000000000100000
000000111111111111111111111111
000011111111000011111111111111
000000000000111000000000000000
000000000000111011110000000000
000000000010011111111000000000
000000001110001111111000000000
000000011111011000110000000000
000000111111110001100000000000
000000110011111111000111101110
000000000001111111111111111111
000000000000111111111111110000
000000000000111111110011111000
000000000001111110000001111000
000000000111110000000000011110
000000011100100000000000010010
000000110001100000000000011001
000000000001000000000000001000
000111111111111111111111111111