110100000001111110000000000000
101000000111111111111111100000
010000001111111111000001111000
100000001111110011000000111100
000000011111101101000000011110
000000011111010111000000001111
000000111111011111111111111111
000111111110001101110000001111
001111111110000011011110000001
011111110110000110000011100000
011111111010001111110000110000
111111111110001000011110011000
111111111010001000000011111000
111111111010001000111000000011
111111111110001011111110000111
111111110110001001111111000111
111111110111011000111111111111
111111101111111000001101100110
111111011111111000001001001111
111111111111110000001001011001
111101111111110000011111010000
111011111111100000010011111110
100111111111000011110001110011
011111111111111111011011011001
111111111110001110111110001011
111111111100110111110110011110
111100001111011011000011110000
111110000111101010001110001111
111111010101011110011111001111
000011010111110000111111000111