001111100000000000000001111100
011001110000111111100011100110
110000111011100000111111000011
110010011110000000000110011011
110111011000111111110010111011
110111010011100000001111110011
011000100110011111110111000110
001101101001100000011001101110
001101000110011111100100110110
011000010100100100010000010010
010000110000001000000000001001
010001110011101000010111001101
100011100101111000001011100101
100111110100110000001001100111
100111110010010000001011000011
101101011001110000000100010011
101101101100011000000100110011
101101100011101000000111100111
100110111001100100000111001111
100111010001010000001110011111
100011100100001111110010011001
100001110110000111110011000001
010000011111000111100001100011
011000011000110001100011110111
011100111101011011110111011111
001111111110101110001111001110
001111110011110000000110000000
000111100011100000000100000000
000000000001111011001100000000
000000000000111111111000000000