000000000000011111111111100000
000000000000001111110011111000
000000000000000111001111111000
000000000000000010111111011100
000000000000000001111110111110
000011110011110000111101111110
000010011100011000011011110110
000101101011101100001111110110
000100101010101100011111110110
000101100011100110110011110110
001110011100011011100001101110
011111111111111101000000101110
111110110111111100100000011110
111111111110111110110000001100
110000000001111111011110000100
011111111111111111000001100000
001111111111111111111110011000
000111111111111111111111101100
000011111111111111111111110100
000000101111111111111111111010
011001011111111111000000111010
110010111111110110011111011101
100101111111110101111111111101
111111111001110101111111111101
011011100001110101111111111101
000000000011100010011111111101
000000000111100001100011111011
000000011111000011111111110110
000000111111000111111111101100
000000111110000111111100000000