000000000000000000000000011110
000011111110000000000000110011
000111111111100011000000110011
001111111111110011000000110011
011101111111111011000000110011
011110011111111011000000110011
111100000000011011000000110011
111100000000011011000000011110
111100000000011011000000000000
111110000000011011000000011110
111111110001111011000000110011
011111011011011011000000110011
011100011000010011000000110011
011100011000010011000000110011
001100011000010111000000110011
001110001100010111000000110011
001110000000100111100000011110
000110011110100110110000000000
000111000000100110101100011110
000111100001000110101010111111
001000011111001110101010100011
011100000001100110101010000111
111110011101100010000001000110
111111011111111001000001001110
111111101111111111000001001100
111111111110111111000001001100
111111111100011111100010001100
111111111100011110110010000000
111111111110001110001110000000
111111111111001111000010000000