000000000000011100000000000000
000000000000100010000000000000
000000000000101010011111100000
000001111000101100111111110000
000010001100011101111111110000
000101010100011101100011110011
000100000100011100101011111101
001111100100011101000001110001
000100000100011110100000101110
010010001000011111101001010000
010001111000011111110010111000
111011000100101111111111111100
000100000010100111111111011110
001000001111110001110111011111
001000000010000000111111011011
001000000010011000110110111011
111000000010100110011101110111
111100000110100111010011110111
111111111110100011101111101111
111100000110011111111110011111
110000000011000111111001111111
110000000001100000000111111111
100000000001100000000111111111
100000000000110000000111111111
100000000000110000000011111111
100000000000110000000010111111
100000000000111100000010000000
110000000000111111000010000000
111000000001111110000010010000
111110000111111111111010010000