111111111111111110000000011111
111111111100000011100000001111
111111111001101100110000000111
111111100110110110011000000111
111111111011011011001100000011
111111111001101001000100000011
000000001100111111110110000011
000000001111000000011111100001
000000001111111000000110100000
111011111101101001111011110000
111011111101011011001100111000
111111111000010110000100011100
110000111001001100000100001110
100000010110000010000000000110
100000100000000000000000000011
000000100000011000000000000011
000000100000001101111100000011
000000110000000100000110000011
000000011000001111110011000111
100000001111111100111101000111
100100000000000000001100001111
110100000000000000000000000011
111100000000000000000000000011
111100000000000000000000000111
111100000000000000000001111111
111100000000000000000001111111
111110000000000000001001001111
111111000000000000011001000011
111111110000000001111001000001
111111111111111111001001000000