000000000111111000011111000000
000000001111111100110011100000
000000001110001110100001100000
000000000111100111100001100000
000000000001111111110011100000
000000000000000111111111000000
000010000011111111111111111100
000110001111111111111111111110
001111011111100111001110000110
000111111001001110000111100010
000011110010001100010111111110
000000000010001100010111011100
000000000100001100011011000000
000000001100001000001011000000
000000011000001000001011000000
000000011000000000011011000000
000001110000000000011011000000
000111101100000000011011000000
001111111111110000011011000000
001111111111111110011010000000
001110000011111111101010000000
001000000011011111111010000000
001000000110000111111110000000
001100001100000001111110000000
000110111100111100011111000000
000001100110001111101111000000
000001101110000001110111100000
000000111110000000001111100000
000000011100111111111111000000
000000000000001111111100000000