000000111100000000000011000000
011101000011000011111110000000
110101100000111111111100001111
100111000011111111111000011001
000000011110000111111000010000
000000110000000001110000010000
000001111110000000100011111000
000011111111110001100110001100
000111111111111011000100000110
001111111111111110011100000010
001000011111111110110111000000
011000000001111100000001100000
010000000000011101110000000110
110000011100001011111001101011
100000111110011010111011010101
100000111010010010011011111111
110000110010010011010111111111
011000010110110001111000000000
001110111100100011111101001101
000011110111100011111100110000
010001100011100111101100000110
011111110011111111100100011010
011100111000011100001111100110
001111001111111111111110011110
001111110000000000000001111110
110111111111111111111111111110
000001111111111111111111111100
111110000000011111111111111001
111001111111100000000000000110
000111111110011111111111111111