111111111110111100001111101111
111111111101100111110111011001
111111001110001101111010110001
111110110110011001011001100001
111110100001111000111011000001
111101101101010100001100000111
111101011000011100011001111111
111101010000001110111111100011
111011111000000001111111111101
110110011100000011111111101110
110100101100000110111111101101
110100111110011000111111011001
110100011010110001101110100011
110110000010100001000011111111
101111001100100011001111001001
011011111000100110011001100011
010111111100011100111100111110
110110111100000000111111001100
101100111100000000110001111000
101000111100000000100000000000
011000111101111100000000001100
010000111011001110110010010010
110001111101100111100101010010
100001110100110110000010111111
100001101010011000000111001101
100011101011010000001001001101
100011001001110000011001110011
011111001101100000100110011100
000001011111000000100110010010
000000111110000000111101100101