000001111111100000000000001111
000011111000010000000010001001
000011110111110000000110001111
000111101100111000001100001001
000111101000011000011000011011
000111010110111000110000011011
000111010000011001100000000000
000111100010010011000000000000
000111110001101111100000000000
000111110100111000111110000000
000111110011110111001011001010
001111110110011011111001111101
001111110100110000001000111111
011100110111011100111000100111
011000110110100011101100101010
110000011101111100010101000000
100001000111100111101001011000
100011001100000000110011010000
100010011010001001100010010000
111111010010001001000110110000
100001100010001001101100110000
110000100010001000111000000000
111101100110001100001000000000
000111000100000110111000000000
001100011111001111100000000000
000111100000111100000000000000
111110101110100111111111111111
111111100000111111111111111111
111110111111101111111111111111
111100000000000111111111111111