000001100000001111100000000000
000010110000011111111110000000
000010010000011111111011000000
011110111000010110111001111000
100011101001100101011111111110
110111111001010110111001111100
011101000000100111111011011000
000111000000100011111110000000
000000101110110001110000001010
010000101010011100100010101010
010001101001000111100010110100
010111000111111111110001010101
101011000111111110110001110111
101010100011111111111000111011
111011101001111011111110011111
010101111100001111011101011101
110101111101001111111011011111
111111111111101111100110111111
111111111111101100011101111111
111111001110001011111100000000
000010000111101110100111110001
010010100111110100110000110101
010010000100010110011111110101
000111001101010011001001110000
101101111000110001101100110000
101010110111100000111100000010
001101101010001001111000000100
100111110110011001110010100101
100000011100010100001101101101
110101000000110100011011011011