111110011110000011100110111111
111110111111000110100111011111
111110010111001101000011101111
111110010011011010000011110011
111100011001111100000001111101
111100000101111100000000111111
011000001101111000000110011111
110000011111100000001111001111
111000011111111111011011100111
111000011101111111110110000100
111000101000111100001100000111
110010101000111111111000001111
000111110000110110000000001111
001111111000011010000000011111
001110111110001011000000011111
011000111111001101000000000111
010100011111000101000000000000
100001000111111101110001111000
100111100000100111011111111100
111100100000101111010011111110
000000110000110000110001011110
000000010000011001100001001111
000000011000001111000001001111
000111110000000110010001000111
001111100010001101110001100000
001110001111111111111000110000
011000111000000000011110011110
110011100000000000111011100001
101100000000000001110000111111
111000000000000001100000000000