000000000000111111000000000000
000000000111111111111000000000
000000011110111111111110000000
000000111101111111111111000000
000001111101111111111101100000
000011110000111111111100110000
000111000000011111111100001000
001100000000000000000000000100
001110000000001111111100000100
011110000000011111111100000110
011110000000011111111110000010
011110000000111111111110000010
111110000000111111111111000111
111110111111011111111111011111
111101111111011111111111011111
111101111111101111111110111111
111011111111101111111101111111
111011111111110111111101111111
010111111111110111111011111110
010011111111111000000011111110
011011111111110000000011111110
001001111111110000000011111100
001000111111100000000001111100
000100111111100000000000011000
000011000000000000000011110000
000001111111110000000111100000
000000111111111000011111000000
000000011111111110111110000000
000000000111111110111000000000
000000000000111111000000000000