000000001111111000000000000000
000000011111111100000000000000
000000011110000100000000000000
000000011100101100000000000000
000000011100000100000000000000
000000001100110100001100000000
000000000110001000001110000000
000000001110110000011011000000
000000111011011100100101111111
000011100111110111011011000000
000110011111111000111110000000
111101111111110111101100000000
100011001111110000000000000000
101110001111011000000000000000
011000001000111100000000000000
000000001111111111000000000000
000000001111111001100000000000
100000001111101110100000000000
000000000111100100100000000000
101000000100100101000000000000
000000000100101011000011111000
001100000110101001111100000100
100000000010101100010000000100
101101000010100111100000001100
000100000010111000000000110000
000010001110001000000111000011
111111110011110000111100111111
001111000000000111111111111111
111111100000111111011111111101
111001111111111111111100111111