111000000001111111111100000000
111110000111000000111110000000
111111111100000000001110001110
111111111111111100000010011010
111111111111111111000000011100
000100000000111111110000011000
000100011110000111111111110000
000100111111000100111111000000
000101111001000110011111111100
000101110111100010001101100110
000101110110010011001100100011
001111110000110011000110110011
010001110010100010100110101011
010011110001101110100111011001
110111100111011011100011000001
101111000010110011000011100000
100100011110000111000001111000
110000000000111101000000101100
011111100000011001000000010010
000100100000001101000000000000
000100101000000111111000000000
000100110000000110001100011100
000101100111111100000111100100
000101001100011111000010011100
001110011000001111110000111100
001111111111100111101101111000
001111111111110010011011110000
001111111111111000111000000000
000000000000001101110000000000
000000000000000111100000000000