000001111100000011111111100000
000011101110000111010010111000
000011011011001101101000101100
000111100111111010111111001010
000111101110001011111111110110
000111111000000111001111111011
000111110000000111110111111111
000111110100101100111100011011
100011110100011011011100011111
110001111000011100111101001111
110001111000111101111001001111
111011110000111111111011011110
111111110000111110111011111110
111111101011011110111011111100
011111101110011001111011111000
001110100100010111111001110000
000000011111111111111000000000
000000001001111111111000000000
000000001111111111111100000000
010010001111111111111100000000
010010001111111101111100000000
110100001111111011111110000000
010110011111110111011111000000
001100011011111110111111110000
001000011011111110111111111000
011010011001111101111111111110
010100011101111111111111111111
100111011100111111111111011111
101100011110111111111111101111
111000001110011111111111111111