000000000000000001100000000000
000000000000000001111111110111
000000000000000000011001110111
000000000000000000010011110111
000000000000000000010011010101
101111000001111010010000010111
011111100010001100011000110111
110011101011000110011111110111
100111001001110110000000000000
101100111110011110011111110111
111011111111101110010111110111
010111100011110100011111110111
001110001000111000011111110110
001100001000011000011110110111
011100001000011100011111110111
011000001000001101111111110111
011000001000001101100000000000
011000001100001101111111111111
011100000110011100000000000000
001100000000011000000011000000
001110000000111000000100100000
000111100011110000000100100000
101111111111111011110011000111
001100111110011000011011001100
011100000000011100111011011000
000000000000000001101011010000
000000000000000011001011110000
000000000000000110001011100000
000000000000001100001011100000
000000000000011000001011000000