000000001111111000000000000000
000000111000001100000001111100
000011011111111100000111111110
000101101111111100001110000011
011110111111111100011000000001
100111111111000100110000000001
100011111100111101110001111101
111111000011100011110011000111
100000111100001111110100000001
011111100000110111101000000011
000000000001001101110110000111
000000000111011100111011001111
000000001100011110011101111111
000000010000110011001110111111
000000110001011001100111011111
000000000011001100110011011101
000000000111100110011001011001
000000001111110011001111011011
000000111111111001101111011110
000001100001111100111110011100
000011000000111110011110111100
000011000000011111111101100100
000101000000001111111011000100
000101100000000111110110000100
000100110000000011101100000110
000110011100000011001100000010
000011000111111110011000000011
000001100000000000110000000001
000000111100000001100000000001
000000000111111111000000000001