111000000000001111110000000000
100100000000011000011000111100
100100000000110000001111100110
101000000001100000111000000010
101000000111111111100000110010
101000011100011110000001001010
101000111111001110000001001010
100101111111100110001111010010
100111111111110110011011010010
010011111111110110110110010010
010111111111111111101100110010
010111111111110000011001110010
010111111111100000110011100010
011111111100111111100110100100
011111111001000000001100111100
011111110000000000111000100100
001100111111111111001000100100
000100100000000001001000100100
111110111111111111111111111111
111000111111111111111111111111
010110001000000001001000100100
010000011100000001111101111100
010000011111000000111101111111
011010111111100000111101111111
010000111111111000111100111111
001111111110000000011110001111
000111111011110000011110000000
000011111110000000001110000000
000001111011000000000000000000
000000111100000000000000000000