000000111100000000000000000000
000011111110000000000000000000
000111111110000000000000000000
001111000011000000000000000000
001110000001000000000000000000
000100000001000000000000000000
111100110001100000000000000000
100100010000100000000000000000
110100000000100000000000000000
011100000000111100000000111100
011100000000000111111001100100
001110000000000000001111001110
000110000000000000000010011010
000100000000000000000000110010
001100000000000000000000000111
001000000000000000000000001101
001001000000000000000000001011
011001000000000000000000000110
010001000000000001001000001100
010001000010001001101010001110
010001100011001100111110011110
011000110001100111110001111111
111000011100110011000011001111
111110000111111110011110001111
011111100000000001110010011110
111111110000000011100011111111
001111111111111110100111111100
011111111111110001111111111110
001010111111111111111110100100
000001100110111111100000000000