000000000000001111100000011111
001111110000111001010000101010
011111111000100101110000111010
111111111101001110010000010111
111100001101011000011000110000
111000000101010000001111100000
111111111101010000000000000000
101001010101010000000000000000
101000000101010000000010000010
100000000101010010000111000010
110011110101010010001111100010
011000001011010010001111100010
011111111110010010001111100010
110000010000010010001111100010
100000010000010010001111100010
100000010000111110001111100011
100000011111101010001111100010
100000010000001110000000000010
100111110001111010000000000010
101100000011000010001111111010
100000000010000010011000001010
100000000010000011111111101110
100000000010000000011000101000
100000000010000001111111101000
100000000010000111111111111000
100000000010001111111111111000
100111111111110000000000001111
101100000000011111111111111000
101000000000000000000000000000
101111111111111111111111111111