000011111000001000000111100000
000110001100101010001100110000
000100000100101010011011011000
000100000100111110110111101100
011111111110011101101111110110
010000000001001001011111111010
001111111110001001111111111110
000101010100001000011100111000
000100000100001000011000011000
000010001000001000011000011000
000001110000001000011000011000
001110001110001011111111111111
011010001011001000000000000000
010011111001111100000000000000
110010001100010100000000000000
100111111111111100000000000000
101111111100001000000000011010
111111111100001000110100101101
101111111100001001011010110101
110111111100001001101010011010
000111111100001000110100001100
000111111100001000011000001101
000111011100001000011011110010
000111011100001000100110010011
000111011100001001100101111010
000111011100001011100111001111
001111011110001000100100111000
011001010011001011111111100011
100001010000101000011000011110
111111011111101011110011110000