010000000000001111000000001110
011000000000011111111000011011
111100111110011111111110110001
111110111011110111111110111111
111111001100111001111110000000
111110000111001110001110000000
011101110011110011100100000000
111101011111111100011100000000
111101000111111111100111111000
110101100011111111111000011000
111110100001110110111111110000
011010111000110101101000001110
111100101110011000001100011011
111001100011001100000100110101
110111011001100100100101101101
101111111110110110011101011101
011001111111010010110011011001
110010101111111010100010111011
100000011100011101100010110010
100000110000000111000011100110
110101100000000100000111001101
111011000000001100111111111011
110110011110111001100111000001
111100110011100011011110000111
111100000000111110110100000011
001110000001101010101100001101
100011000001001011111011110111
111001110011001101100000111100
111111111110011000001111111011
111111110011110111111110111111