000000011110000000011111100000
000000110011000011111110111000
000001101111100110001111011100
000001011110100101111110110110
000011011101011011111100111011
000010111100011010001101111011
000110111100001011110101011011
001100011000110110100111011011
001110000011100100000011010111
011111011000110010100110110110
111111101110011011000101101110
111111101011001010000101101110
101110100010111001110110101100
100000110010000000010010111000
110000011101000000111110111000
111100001001100001100011011100
111111001000111111000011111100
011111101100011000000011111000
001111100110000000010010111000
000111001011000000110110111111
000110011001111111100100011001
000110010000001110000101110111
001111010000001000000101011100
111101011000011000001101101110
111001101000011111111000001110
000000111000110111011100001010
000000000000101111101100000000
000000000001101111111100000000
011010111001111111111101011011
110111111101111111111101101111