001011011101110110110000000000
001011011101110110111000000000
011011011110111010111100000000
011011101111011110111110000000
011011110111111111011111000000
011101111111111111101111000000
101110111111111111111111100000
101111011111111111111111100000
110111111111110011111111100000
110111111011111101111111110000
111001111110110010011111110000
011110111111001111101111110000
101111100011111111111111100000
101111111111111000111000000000
110111001111100000010111111000
111000111111000111011100111110
111111011110001111101111111111
011110111110101011100111100000
001101111100100111000110000000
000011011100010000001011111111
000110111000001110010100111110
001110110000000000100100010000
001101110000000011111010011000
011011100000000011000010101100
011110100000000110001100100100
111110100000000110010001001100
101101110000000100100110010110
011011011000001100101000010110
110110111100011101001001101110
111101101011111101010110011110