000000000000111111000011111100
000000000011100011110110011110
001110000110001111111100101111
001011101101111111110011111011
001100111111111111101110001100
000110000000001111111001110110
000011111000000000001111101011
000000111111100000010110111101
000000011101111101110110001101
000000101100110110001110000111
000000100100000111111100111000
000000100110000011100001101000
000000100000000111110011001100
000000110110001111110110000100
000000011000110111001111000100
000000001111100110111111000110
000000000111000001111101100010
000011111100000111110000100011
000111110110001111101110100001
001111110011011110001111100001
001111110000111100011111100011
011110111001111000011111111110
011110111011110100011111110000
011101100111101100011101110000
111011000011011000011101110000
111010000010110000011100110000
111011100001100000101110110000
110111100001111100110111100000
101111011011111111011111100000
011110001111111111111111011111