000000000000101010100000000000
000000000000101010100000000000
000000000000010101000000000000
001111111100001110000111111110
011111110100111111000101111111
001100000110110101001100000110
000110000010011110001000001100
000011000000011110000000011000
000001100000001100000000110000
000000100000010110000000100000
000000100000011111000000100000
000000100000100110000000100000
000000100000101010100000100000
000000100000111111100000100000
000000100001110001010000100000
000000100011100111111000100000
000000100110001111111100100000
000000111100110000011111100000
000001101110011111111101110000
000011100111111111111110010000
000101100010000000000000110000
100101100001111111111111101000
111111100001111111111110101001
100111110011100000000010111111
000011111111111111111111111001
000001111111111111111111111000
000001000000100000000000100000
000001000000100000000000100000
000011000001100000000000110000
111111111111111111111111111111