000000000000000000000000000000
000000000000000000000000000000
000000000000000001000000000110
000000000000000001100000001110
000000000000000001110000001110
000000000000000001111000001110
000000000000000001111000011110
000000000000000001111100111110
000000000000000001100110111110
000000000000000001100111011110
000000000000000001110011011110
000000000000000000110011011110
000000000000000000110011011100
000000000000000000110011011100
000000000000000000110010011100
000000000000000000011010111000
000111100000000000001110111000
001111110011111110000111110000
001111110111111111101111111000
001111111111111111111101111100
001111111111111111111100111100
000111111111111111111111111110
000001111111111111111111111110
000001111111111111111111111110
000001111111011111111111111100
000001111111011111111111100000
000000111111001111111000111100
000000011111111011111111011110
000000000111111000111111011110
000000000000000000000000000000