000000000000011110000000000000
000000000000111111000000001110
000000000000111111000000011111
000000100000011110000000111111
000011000000111000000000011111
000110000001100000000000001110
000100000011000000000000000100
001100000010000000000000000000
001000000110000000000000000000
001000000100000000000000000000
011000001100001100000011000000
011000001100011110000111100000
011100001100011110000111100001
011100001100011100000011100001
011100001110001000000001000011
011110011111000000000000000011
001110011111100000000000000111
001111011111110000110000001111
001111111111111000000000111111
000111111111111100110011111110
000111111111111110001111111110
000111111011111111111111111110
000011111011111111100111111100
000011111011111111000011111100
000001111001111111000011111000
000000110001111111000111111000
000000000000111111000111110000
000000000000111111100111100000
000000000000011111100011000000
000000000000000111000000000000