000000000111111111100000000000
000000001100000000110000000000
000000001001110110010000000000
000000001100000000110000000000
000000000110111111100000000000
000000000011100000000000000000
000011110001100000000011100000
000111111000100001111110110000
000111001100000001100100111000
000111111110000000110111111000
000111110011000000011001111000
000011111111100000001111111000
000011111000000000000111110000
000011111100000000000111110000
000111001110000000000111110000
000111000111111000001110111000
001110000111110000011100111000
001111000011100000111000111100
001111000011000001111000011100
011111100011000011110000011110
011111100011000111100000111110
011100100001000111000000111110
011000000001000001000001111111
111000000011000001100011111111
111000000010000001100001111100
001100000010000000110000011100
001100001110000001111000011100
001111111110000001111111111110
011111111111000001111111111111
001111001110000000000011100000