000000000001011110100000000000
000000000010100001010000000000
000000000111000000111000000000
000000000110010010011000000000
000000000010000000010000000000
000000000110010010011000000000
000000000011011100110000000000
000000000001100001100000000000
000000000011111111110000000000
000000001111010010111100000000
000000011110010010011110000000
000000111100110010011111000000
000001111001100011001111000000
000011110001000001000111100000
001111110011000001100111110000
111111100010000000100011111100
111111100010000000100011111111
111111000110000000110011111111
111101111100000000011110111111
100001010100000000011010011101
100001110101010101010110000001
100000100100101010011000000001
100000001101010101001100000001
100000011010101010100110000001
100000011111111111111110000001
100000000010010100100000000001
100000000010010100100000000001
100000000010010100100000000001
100000000011010101100000000001
111111111111110111111111111111