000001111110001111111111111111
000011000011100001000001110011
000001111000110001000011000011
000111111110011001000110000111
001111111111101101001100101101
011111111111110100011001101101
011101110111111100110011000111
011111111011111000110010000011
011100001111111101100010000111
001101101111111101100110001101
000100101111111101101100001101
000100001111110011101000000111
000111001101111011001000000111
000001111011001111000000001101
001100001110000111000000011001
011110001100000011000000001101
111111101000010001100000000111
011010111110011000110001110111
010010100010001000010011011101
111001110000001000011011000001
101000011000011000001110000001
001100011100110000000100000001
011110110111100000000110000001
011111000000000000000011000001
001110001100011000000001000001
001011111110001110000001000001
111011011110000011100011100001
111101101100000000011000111001
111101111010101101101101101101
111111111111111111111111111111