000000000000000000000000000000
000000000000000000000000000000
000000000000000000000001111111
011111111111111111111101111111
011111111111111111111101111111
011011111110111111000101111111
010011111100111111010101111111
011011101110110001110101111100
011011000110111111000101110000
011011101110110001011101100000
011011111110111111000101001000
010001111100011101111101100001
011111111111111100111101110011
011111111111111110011101110011
000000000000000001001001100001
111111111111111111100111001001
111111111111111111110011001001
111111111111111111111000011000
111111111111111111111100011000
111111111111111111111110110010
111001111111001111111110100110
110000111110000111111110100110
100000011110000111111110111110
110000111100000011111100000000
111001111001001001111100000000
100000011010000101111100000000
100000011110000111111110111110
100000011100000011111100011000
000000000000000001111001010010
000000000000000000000000000000