111110000011110000000000000000
111000011110000000000000000000
100001111000000001111111111100
000111100000000001111101111100
001110000000000110000101000011
011100000000000111111111111111
111100000000000110001101100011
111000000000000111111111111111
111000000000000000111111111000
110000000000000000000000000000
110000000000000000000000000000
100000000000000000000000000000
100000000000000000000000000000
000000000000111000000000000000
000000000000010000000000000000
000000000000111000000000000000
000111111111111111111111000000
000100000000111000000001000000
000100000001000100000001000000
000111111111111111111111000000
111110011101111101110011111000
111110010111111111010011111000
111111111110000011111111111000
111101110010000010011101111000
111101100001000100001101111000
111101000000101000000101111000
111111111111111111111111111000
111100000000000000000001111000
011110000000000000000011110000
000001111111111111111100000000