000000000000000000000000000000
000000000000000000111000000000
000000000000000011111110000000
000000000000000111111111000000
000000110000101111111111100000
000011100001101111111111100000
000110000011011111111111100000
001100000111011111111111100000
001000001110111111111111100000
011000001110111111111111101000
010000011110111111111111101100
110000011110111111111111011100
100000011101111111111111011110
100000011101111111111111011110
100000011101111111111110111110
100000011101111111111110111110
100000011101111111111101111110
100000011101111111111001111110
110000011110111111110011111111
010000011110111111100111111101
011000111110111111001111111100
001111111100111110011111111100
000011110000011000101111111000
000000000000000011101111111000
000000000000001111001111110000
000000000000001111001111110000
000000000000001111101111100000
000000000000000111101111100000
000000000000000111101111000000
000000000000000010000011000000