000000000000000000000000000000
011111111111111111111110000110
011111111111111111111100000010
011111111111111111111000000010
011111111111111111111001000010
011111111111111111111011100110
011111111111111111111001111010
011111111111111111111001111110
011111111111000001111100111110
011111111100000000011100111110
011111110000000000001110011110
011111100000000000000110001110
011111000000000000000011001110
011110000000000000000011000110
011101100000000000000010000010
011111000000000000000000000010
011110000000000000000000000010
011100000000000000000000000010
011000000000000000000000000110
00_181_182_183_184_185_186_187_188_189_1810_1811_1812_1813_1814_1815_1816_1817_1818_1819_1820_1821_1822_1823_1824_1825_1826_1827_180
011011111111111111111100011110
011000000000001111100010001110
011110001111111100111111111110
011111100000000111001111100110
011111111110000000011100001110
011111111000011111101100111110
011111111111110000011001111110
011111111111111111110011011110
011111111111111111111000111110
000000000000000000000000000000