001111011111100000000000100000
011001111111111000000001110000
111101111111111100000000100000
100111111111001100000011111000
101011111100010100000001110000
111011111100110110000111111100
010011110000000010000011111000
010111111001000110001111111110
001111111001110100000111111100
000011111100011100011111111111
000001110111110000000111111110
000011101111000001111011111111
000111101111111111111101111100
000111101111111111101100110000
000111101111111111000000000000
000111011111111000011110001111
000000111111110000011111011111
000011111111111000001111011110
001111111111111100000111111100
011111111111111110000000110000
110111111111111111001111111111
111011111111111101101000110001
011100000000000011101010110101
001111111111111111101000110001
000111111111111110001111111111
000001001001001000001111111111
000001001001001000001000110001
000001111001111000001010110101
000001111101111110001000110001
000001111101111110001111111111