000111011100000000000001111110
001101110110000000001111101111
001000100010000000111111110111
001000000010000000111111111011
001100000110000000011111111011
000111011100000000010111111011
000001110000000000111111110011
000000100000000000011111110111
000011111100000000001111101111
000000111110000000000111001110
000000000111000000001111101100
000000000011100000111111110110
000000000001110001111111110000
000000000000111011111111110000
000000000000011111101111110000
000000000000001111011111110000
000000000000000000011111110000
000000000000001111001111110000
000000000000011111100111110000
000000000001111111110011110000
000000000011111111111011110000
000000000111110011111111111000
000000001111101101111111111000
000000011111011110111111111100
000000111100110011011111111110
000001110011100001111111111111
000011101110000000111111111111
000110011000000000011111111111
011110110000000000001111111110
111001100000000000000111111100