010000011110000110000111000000
011001111111000111001101000000
001101111110110011011111000000
000110111101110001011110000000
011011011011111001110000000000
111101101111111001101111000001
111110001111111011001111110011
111111111000000010110111101110
000001111111110110111011011000
111111101111110101111110110110
111111101111100101111110001111
011111101111000100000011111111
001111101101110101111111110111
000000000000011100111110111011
000000000001111100011110111100
000111110101110100111110111110
001111110110000101100110111000
010111101111000111000000000000
111011101111000110000111000111
111111111111111110001110001101
111100001111101110011110001111
111011101000000010011100011110
110111011111100011001100111100
001100111111100001000111100000
011011101111100001011100111000
110111110111100001010000111100
100111111011000111100000011110
000011111010001110100000001111
000000000000011110100000000000
000000000000111100100000000000