111111111111111111111111111111
111111111111111111110000111110
111111111111111110000111111100
111001111111111000111111111000
000000001111100111111111110000
100000000110011111111111100000
110000000101001111111111000000
111000011010000111111110010000
111111110110000111111100111110
111111110110000111111011100111
111111101110000111110010110101
111001011111001111100111011101
110010000111011111001111100011
100001100011011110001111110111
100011000001111100001111111011
000110000001111000001111111011
111010000001110000001111110110
000010000011100100001111001110
011010000111001100000110111100
101101001110001110000011111000
100101011100001110000001000000
110000111000011111000011000000
111101110000011111000010000000
111111100000011111000110000000
111111000000011111001100000000
111110000000001110011011111000
111100000000001101110111111111
111000000000000111011111111110
110000000000111100000011111100
100000011111100000000001111000