000000000111111111111100000000
000000011100000000001110000000
000001110000000000000011100000
000011000000000011111000110000
000110000011111111001100011000
001100000011111110000010011100
001000000011111110000110001100
011000000011111111001110000110
010000000011111111111100000010
110000000011111111111001100011
100000000000011111110111100011
100000000000001111101110000011
100000111111100111111000100011
100011111111110011111111100111
100111100001111001111111000111
101111111100011000110000001111
101110000010001100011110011111
111111111000001110000001111111
111110000110000111111111111111
111100111000000001111111111111
111111111000000000001111111111
011111110011100000001111111110
011111110111110000001111111110
001111111111110000001111111100
001111111011100000001111111100
000111111100001100001111111000
000011111111111111111111110000
000001111111111111111111100000
000000011111111111111110000000
000000000111111111111000000000