000000000000000001000001000000
000000000000000011100011100000
000000000000000110111110100000
000000000000000111111111110000
000011111100000111111111110000
001111111111000111001100110000
011111111111110011111111110000
011111111111111101111011100000
111111111111111110111111000000
111111111111111111011110000000
111111111111111111111111000000
111111111111111111111111100011
111000111111111111111111111111
011110001111100000000000000000
011111110000011111111111000000
001111111111111111111111100000
000111111111111111111111110000
000001111111110001111111110000
000000001111100000111111110000
000000000000000000111111110000
000001111111110001111111110000
000011111111111111111111110000
000111111111111111111111100000
000111111100001111111111100000
000111111000000011111111000000
000111111000000000000000000000
000111111000000000000000000000
000011111000000000000000000000
000001111110000000000000000000
000000011111000000000000000000