111111000001111111100000111111
111100001000011110000100001111
111001111111000000011111100111
110011111111110011111111110011
100110001111111111111111111001
101100111111111111111111111101
001001111111011011110101111100
011011111111000011100001111110
011001000011000010100001111110
011100000001000010100001111110
011100000000100110110011111110
011100000000000110010011111110
011110000000000111000001111110
011110000010000011100001111110
011100010010011011100001111110
011101110011010011100001111110
001101110111011111000001111100
001100110011001111000000111100
100111111111111110000000111001
100111111111111110000000111001
110011111111101111100011110011
111001111111100000001111100111
111100111111111111111111001111
111110011111111111111110011111
111111001111111111111100111111
111111100011111111110001111111
111111111000111111000111111111
111111111100011110001111111111
111111111111001100111111111111
111111111111100001111111111111