000000000111111111111000000000
000000011100000001111110000000
000001110000000111111111100000
000011000000001111110111110000
000110000000011111110111111000
001100000000011110100010111100
001000000000111101110111011100
011000000000111111010101111110
010000000000111101100011011110
110000000000110000000000000111
100000000000111101100011011111
100000000000111111010101111111
100000000000111101110111011111
100000000000011110110110111111
100000000010001111100011111111
100000000010000011110111111111
100000010111010001110111111111
100000111010111000111111111111
100000011010110000011111111111
100001001111100100011111111111
110011111111111110011111111111
110001001111100100011111111110
011000011010110000111111111110
001000111010111000111111111100
001100010111010001111111111100
000111000010000011111111111000
000011100010000111111111110000
000001110000011111111111100000
000000011111111111111110000000
000000000111111111111000000000