011111100000110000011111100000
111111111000111000000100111000
110011111100111000000110001100
100000011110011100001111010110
000000000111001100011111100110
000111111011100110111111110011
001100110001110010111111111111
011001100000110010111111111011
110101110000011010111111110001
100011111000001010111111100001
101111111100101010111111000000
111111111101101110100000000000
111111111101110111111111111100
101111111101110110000000011110
000011111101110101111110001111
111001111101110100110011100111
111110000110110100111000110000
011111100011010100111101011000
000000111001010101111110001000
001111001111011001111111101100
111111110001001101111111111100
111111111001100101111111110100
111111111100100101111111100100
100000111110110101111111000000
000000011111010111000000000000
001110001111010100011111000000
011111101111111101111111110000
111111110111111011111111111100
110001111001110111000000011110
100000011111111100000000000011