000000000011111111111100000000
000000001111111110001111000000
000000111101111011000011100000
000001111100111011001101110000
000011111100111011001100111000
000111111100111011001100011100
001111111100111011001100001100
011111111100111011001100000110
011111111100111011001100110110
111111111100011011011000110011
111111111110011011011001110011
111111111110011111011001100011
111111111110011101011011100011
111111111110100011101011000011
111111111110000011110111000011
110001111110000011111010000011
110000111110011010111110000011
111000011110111100011110000011
111100001100111100011110000011
111110000000111100011110000011
011111000000011100111100000110
011111100000001101111100000110
001111110000000111111000000110
001111111000000011111000001100
000111111100000011111000011100
000011111111000011111000111000
000001111111111100000001110000
000000111111111100000011100000
000000001111111111111111000000
000000000011111111111100000000