000011111111100000000000000000
000110000000111111111000000000
001100000000011111111111000000
011000000000001111111111110000
110000000000000111110000011000
100000000000000111000000001100
100000000000000010000000000110
100000000000110010011000000010
100000000001101010101100000010
100000000001111010111100000010
100000000000110010011000000010
100000000000000010000000000010
110000000000000111000000000110
011000000000001101100000001100
001100000000111000111000111000
000110000001101101101111110000
000011111111000111000011111000
000001111100000010000001111100
000011110000000000000000111110
000111100000000000000000011111
001111100000000000000000011111
011111100000000000000000011111
111111100000000000000000011111
111111110000000000000000011111
111111111000000000000000110111
111000011110000000000011100001
100000001111000000001111000000
000000111111110000111111110000
000001111111111111111111111000
000001111111111001111111111000