000000000000000000000000000000
000000000000000000000000000000
000000000000000000000000000000
000000000000000000000000000000
000000000000000001111000000000
000000001110000011001100000000
000000011011100110000110000000
000000110000110100111011000000
000000100000011111100001000000
000000100111111001111001000000
000000100000010001000111000000
000000110001110011111100000000
000000010011011110000110000000
000011111000001001010011001100
000111111000011000111001011110
001111111101111101101101011110
001111111111111100101101111110
001111111111111110101111001100
001111111111110000111110000100
001111111111100000000000001100
000111111101100011000000001000
000001111001100001000000011000
000000000000110001100000110000
000000000000011001111111100000
000000000000001100111100000000
000000000000000111011100000000
000000000000000001111000000000
000000000000000000000000000000
000000000000000000000000000000
000000000000000000000000000000