111100011111111111111111111111
111110000111111111111110011111
111110001100001111111111110111
111111011111110011111111111011
111111111000011101100011111101
111111101100000100100000111111
111110000110000000000000001111
111110000011000000000000000111
000110000000000000000000000010
111110000000000000000000000011
111111000011000010000000000001
111111100011000110000000000001
111111100000001100000000000000
111001110000111100000000000000
110111111111101000000000000000
101111100000001000011100000000
101111001110001001110000000000
111111001111111011100000000000
111111111111111011000000000000
000000111111111011000000000000
000000000011111011000000000000
111110000000110011100000000000
111111111000100111110000000010
000001111100111111000000001110
000000001111001100000111111100
000000000011101111111111111000
111111100100110000000011110001
011101110111011001111111000011
001111111111101011100000000111
111101111111101010000000011111