111111110111111111111111111111
111111111111111001111111111111
111111101111111000011111111111
111110000111100000000111111111
111100000111000000000011111111
111000000011000000000011111111
111000000001000000111011111111
110000000001100001100011111111
110000000001100011000101111111
111000000000100111001101111111
101110000001110111111001111111
100011000011110011111001111111
110000000100011100011000111111
111110000100111100000000111111
110111000110011100000000011101
100000000110001100000000001100
000000000110000100011000000110
000000000110000100001000000010
000000000110000100110000000000
000000000011000111100111100000
100000010111000011110011011000
100000001111000011111110000010
100000000000000111111101100001
110001111111000111111111000001
111000101110000111111111000011
111100011100001110111111100111
111110000000011110111111111101
111111000000011110111111111011
111101100001110101111111111001
111100111111100101111111111101