000000111111111111111111111000
000001111111111111111111111101
000011100111111111111110001100
000111100011111111111101001110
001111101111000000000111111111
001111111000000000000000001110
000111100000000011110000000111
001111011000000110011000000010
011110110000000011001000000001
011110000000000011101000000001
011111111000001001101000000000
010011101100011101101000001000
001000110110011000111000000000
000100010010000000110001001000
100110011011000000000000001000
010111001001000000000001001000
011011001001000000000001001000
011101001001000000000001000000
011111001001000000000000000000
011111001001000000000000001001
011111001001000000000001001001
001110011001000000000001011011
100100010011000000000011010111
110000110010000110000010001101
011101100110000111000100011001
000111111100000101100001111001
111111111111000100111111111101
111111111111111100111111111111
000111111111111100111111100000
000000000001111101111000000000