000000000111111111111100000000
000000011111111111111111000000
000001111110000000011111100000
000011110000000000000111110000
000111011110000000000011111000
001111111111100000000001111100
001111110001110000000000111100
011111101110111000111111011110
011101010011011011111111111110
111101010111011111000000011111
111001010111011100001111101111
111001011000111001011111110111
111001001111110011011100010111
111001100111000111011011010111
111000110000011111011011110111
111000011111000111011011101111
111000000011110011011100011111
111000000111111101011111111011
111000001111111110010111100111
111000011110001110010000000111
011100011101110111010000001110
011100011011110111010000001110
011110011010110111010000001110
001111011010001110110000011100
001111011011111101100000111100
000111111101111011000001111000
000011111110000110000111110000
000001111111111100011111100000
000000011111111111111111000000
000000000111111111111100000000