000000000000001110000000000000
000000000000011011000000000000
000000000000110011000000000000
000000000001101011000000000000
000000000011011011100100000000
000000000111111011100110000000
000000111111111111100111110000
000001111111111111100011111110
000011111111111111110001111111
000111111111111111110000111111
001111100001111111110000011111
001111000000111111111000001111
011110000000011111111000001111
011110011100001111111000011111
011100111110001111111000011111
111100101110001111111000111111
111100100110001111110000111111
111100110110001111110001111111
111110111110001111100001111110
111110011100011111100001111100
011111000000111111000011110000
001111111111111110000011110000
000111111111111100000011100000
000001111111111110000111000000
000000111110011110000111000000
000000000000111111000110000000
000000000001111111100110000000
000000000001111111101110000000
000000000111101111111100000000
000000000111011111111000000000