010110000100000000000000000100
001000100110001111111111000100
001000000010111111111111101100
000000000111111111000011111000
001000111111111100000001111110
000001111111111000000000111111
001001111111100000000000011111
000011111111011100000011101111
000011111110000111001110000111
001011111010011000001001100111
001001111010011100000010100111
001001111110011010000110000111
001001111111000000000000001111
001000111111000000110000001111
001000011101000000000000001111
001000011101100111111111001011
001000011100110011000110011010
011100001100011001111100110000
010100001000001100000001100000
010100000000000110000011000000
111111111111111111000111111111
000011111111111111111111111111
011111111111111110000111111111
010111111111110110000101111101
111111111111100011001100111001
000101111000000001101000001001
010101110000000000111111111001
011101100000000000011000000001
010011000010000000001111100000
010110000011000000000010000000