111111111110000000111111111111
111111111100000000011111111111
111111111000000000001111111111
111111111000000000000111111111
111111110000110110000111111111
111111110001110111000111111111
111111110001110111000111111111
111111110100110110010111111111
111111110110000000110111111111
000000110010101010100111000111
100000000011111111100100000000
110000000001010101000000000001
111100000000000000000000000011
111110000000000000000000011111
111111000000000000000000111111
111111000000000000000001111111
111111100000000000000001111111
111111100000000000000001111111
111111100000000000000001111111
111111100000000000000001111111
111111100000000000000001111111
111111100010000000000001111111
111111110010000000000011111111
111111110011000000000011111111
111111111011000000010111111111
111111111011100000010111111111
111111111111100000011111111111
111111111111110010011111111111
111111111111111010111111111111
111111111111111110111111111111