000000000000000000000000000000
000000000000000000000000000000
000000000000000000000000000000
000000000011111111000000000000
000000011111111111100000000000
000000000011111111110000000000
000000111100011100111000000000
000011111111111101011000000000
001110000111111101111110000000
000001111000011110111111100000
000011111111111111111110110000
000111111111111111101111111100
001100000011111111011111111110
000011111100001111011111111110
000111111111111111011111111110
001111111111111111101111111100
000000000001111111101111000000
000011111111111111101111111100
000111111111001111110111111000
001111100000111111111011111000
000000001111110011111100110000
000000111111101111111111000000
000001111110011110110111000000
000000000000111101110111100000
000000000000111011101111100000
000000000000100011001101100000
000000000000000010001101000000
000000000000000000001001000000
000000000000000000000000000000
000000000000000000000000000000