110111011101110111011101100001
101110001110001111001111000011
111111111111111111111111000010
010000000000000000000010000010
011111111111111111111110000010
011111111111111111111110000010
010101010000000000000010000010
010101010111100001111110000010
010101010000000000000110000010
010101011111110011111110000010
010101010001100010011010000010
010101011111110011111110000010
010101010000000010000010000010
010101010000000010000010000010
010101010000000000000010000010
010101010000011001000010000010
011101010110011101001110000010
111010101100011111000110000010
101010100111100000111110000010
101010100000011101100001000010
101010100001100010010001100010
101010100000000000000001111010
101010101000000000000001100110
010101011000000000000101011011
011100111010101001010101111011
011110111010101001010110111011
111111010101011110101010000110
001111100010101111010100111100
100111111111111111111111111001
110011110000111111100001110011