000000000001111111111101111000
000000000111111111111011111100
000000001110111111111011111110
000011111110011111110111111111
000010000100011111110111111111
000111111110001111110101111111
011110111010000111110111011111
010111100010001111010101111110
011100100010001110000000111111
001000111110011110001110011111
010001100011001110010000101111
011111000001011110000111101111
010110000111111110001111111111
010010001100111100001011001100
001111111011111100001111000000
011000011111111000001101001000
011111111111111000100110001001
000001111111110000100000001011
000001111111100000100000001100
000000110001000000000000001100
000000001001000000000000011100
000000011111100011111000011101
000000111011110001110000111111
000001110001111000000001111111
000001111001111110000011111101
000001111111111111101001111111
000111111111111111000001101111
001101111111111111000001111111
001111111111101111000001111111
001111111111111010000000001111