111000110111011101110111011111
110011101110111011101110111011
100001110111011101110111111111
100011111011101111111010101111
000111010000000000000111111011
000010100000000000000001101111
000111100000100000000000111101
000010100000000011111000111111
000011111110001110001100110111
000011110011011100000010111111
000001111001011100111101111101
000001101111011011110001111011
000001100011010000000011111011
000001100001010000000011110111
000001100001010000000001111110
000001100001001000000000111110
000001100000000100000000111100
000001110001111100000000111101
000001110000110000000000110101
000000110001001000000001110101
100000111001111100000001110001
100000101101000010000011110001
110000110110111101000111110011
110000010110000000101111111011
111000011111000001111111111111
111100001111111111111111100111
111110000011111111111111000011
111111001110111111111111001110
111111111100111111111111111000
111110000001111111111100000000