000000000111111111111000000000
000000011100011001111110000000
000001110010110111001111100000
000011001011101111011011110000
000110001001011110000000111000
001100111101011100111110001100
001011000111001101110111111100
011001100011101001110001110110
010000110011100011111101000110
111111110101101111110000011111
100011011101101000100111001101
100110001001100011001111100001
101100111101110111111111111111
100000000100110000000001110001
100111001111111100111100100111
100001011000011110011110001111
101111110000110111001111100111
100100001111100011100111110011
100000111110000001100111111111
100011100100000001100111111111
110000011100000011100111111111
110000110000000011100111111110
011000000000000111001111111110
001000000000000110011111111100
001100000000011110011111111100
000111000001110001101111111000
000011100011000101110011110000
000001110000011110111111100000
000000011111111111011110000000
000000000111111111111000000000