000000000000001111110000011100
000001110000011111111100110110
000011011000011111111110111110
000111101100010111110011011100
001111110111001011101111110000
001111111111100111011110100000
001111110111111000010110110001
001111100011111111001100010111
011111100001111111100000011111
011111000001111111110011101110
111111000000111111111001111000
111111000000011111111100111100
111111111111001111111110011100
111111000001101111111111000101
111111111110000111111111100101
111111010111000111111111100101
111111001111100011111111100101
111111000000000001111111100111
111111000000000001111111100111
111111000000000000111111101111
011111000000110110111111101110
011111100000011100111111101110
011111110000000000011111101100
001111110000110110011111101000
001111111001111111011111100000
000011111000111110011111100000
000001111100011100011111000000
000000111110000000111110000000
000000001110000000111100000000
000000000011000001111000000000