000000001111000000000000000000
000000011001100000000000000000
000000010001111000000000000000
000111110011001100000000000000
001000110010000111111000001110
010000010010000111111110011011
010000011010000111111111010001
010000011110000111011111110001
010000011011000110011111110001
010000010001101111111100111010
001000100000111111101101111110
001111100000110111001111100010
001111100001000011111111000010
011000110001000011111111000010
010000010011000001111110000011
110000011010000101111110000001
100000001010000100111100000101
100000001010000010111100000101
100000001010000010011000001101
100000001010000011011000001101
100000101010000011011000011001
100000101010000011010000011011
100001101110000110010000111011
100001101111000110110000110011
100011101111000100110001110111
100011101111100001110001100111
100011001111110011110001101111
110010011111111111111001001111
110000011111111111111100011111
111000111111111111111111111111