111110010011111111111111100011
111110000011111111111111001001
111111000111111000001111011101
111111101111100000000111011111
111111111111000000000011001111
111000011110000000000001001100
111100001110000000000001101100
000110000110000011111101101011
110011100010000100000001110111
100000111010000100100101101111
111100001101001000000011010011
110000000110111100011010100011
111110000000000110000101100111
111000000000000011001111001011
111110000000000110000111001011
111111100000001100000000001011
110010011000111000000000010011
100000001111100000000111110011
100000001100000000001111110011
110000011000000000001111110111
111000111000000000011111100111
111101111000000000111111001111
111111110000100001111110011111
111000000001100011111100111010
110000000011000111111001111000
110011111110001111111011111101
110111100000011001001011101111
111111000000111000001001001111
111111001111111100011100011111
111111101111111110111111111111