000000000000100100000011111000
000000000111001000001111111100
000000001110011010011111111100
000000111111100100111100001100
000011111111001100111001110100
000110110001110001111011110100
001111111000000001110011001100
000001111000000011110000011000
000000111100000011100011111100
000000111111001111101111111100
000000111111111111011100001100
000001111011111011110011100100
000001111100110111000001110100
000001111011100111111100110100
000000111100011110011111001100
000000111111111111000011111100
000000011111111001101100111000
000000000111110001100100011100
000000000010100011010110001100
000000000111100011010010100100
000011111111111110010010110100
001111111111111110010010110100
001111001010011100010000110100
000000000001110010110001001100
000000000011001100100101111000
000000000110011101101101111100
000000000110111101011101111100
000000000110111001011101110100
000000000111000011100011111100
000000000011111111111111011100