000000000000000000000000000000
000000001111000000000011111000
000000011111100000000111111100
000000011001110111101111001110
000000011000111111111110001110
000000011100111101011110011100
000000001111111111111111111000
000000000001111001001111000000
000000000011111000001111100000
000000000111111110111111110000
000000001111111111111111111000
000000001111111111111111111000
000000011000000000000000011100
000000011000001101101100011100
000000011111111001100111111100
000000011100001100001100111100
000000011110000000000001111100
000001110111000010010011111100
000011111011110000001111111000
000011111111111111111111111110
000011111111111111111111111111
000011111111111111111111111111
000011111111111111111111111110
000110111111111111011111111100
001100011111111100000011111111
011000111000000000000000000101
011000101000000000000000000000
011000000000000111111111110000
001100000000111100000000011111
000111111111110000000000000000