000000000000000000000000000000
000000000000000111000000000000
000000000000011111110000000000
000000000000001101111100000000
000000000000111011100110000000
000000000000111100101100000000
000000000001100110101000000000
000000000000111001111000000000
000000000000001110110100000000
000000000111110001100111000000
000000011100011110011111100000
000000110011100111111111110000
000000000110011111001111110000
000000011101111000011111011000
000000010011100000000111101000
000000000111001100110111101100
000000001111000000011111101100
000000111111111010001111000100
000001111100010011001111100100
000011111110000000011111001100
000110111111100001111110001100
000101111111101111111111011100
001100111111011111111110011000
001000000011111111111100111000
001111111000011111101000110000
001110001110000110011101100000
000111110011100000110011100000
000000011111111100001111000000
000000000000011111111110000000
000000000000000011111111000000