001111111000011000000000000000
001110000011011011011000000000
001110110011001011011000110000
001110111001001001010110110000
001110001111111111010110100000
001111101101101101111101100000
001111100111111111101111000000
001111110111111111111101000000
001111110111111111111111000000
001111101111111110110110000000
001000010000111100010010000000
000011110110011100010010000000
000111111010011111011010000000
000111100000000111011001100000
001111000000000010000011000000
001111000011111011000000000000
001111100110110001100000000000
001111110000011000000111000100
001111111100001100000111111100
000111111110000100000011111000
000111111111100010000001110000
000011111111111011100001100000
001001111111110001111110000000
001100101111111000111110000000
001110000111111000010100000000
001111010100111100000010000000
001111110001010100000010000000
001111111011000110000110000000
001111111111110011111100000000
001111111111111011100000000000