000000000000000000000000000000
000000000000000000000000000000
000000110111010000000000000000
000001111011101000000000000000
000001111101110100000000000000
000001111101011000000000000000
000010111101111111000000000000
000111001011111111011110000000
000111110111111110111011100000
001111111100000001111101110000
001111111110111111111101110000
011111111110111111111101111000
011111111111011111111101110100
011111111111001111111011110100
011111111111010111110111110100
011111111110110111110111110100
001111111101110111101111110100
010111111011110100010011110110
001001111011110011110001111010
001110000001110011110000111010
001110000001110001110000111000
000110000001100000110000011100
000110000011100000110000011100
000110000011000000110000001110
000110000011000000110000000110
000110000011000000110000000110
001110000011000001110000000110
001100000111000001100000001110
000000000110000000000000001100
000000000000000000000000000000