000000000000000000000000000000
000000000000000000000000000000
000000000000000000000000000000
000000000001111111000000000000
000000000011100111100000000000
000000000110000001110000000000
000000000100000000110000000000
000000001000011111111000000000
000000001011111110011000000000
000000000111111111011100000000
000000011111111111111100000000
000000111000011111111100000000
000001110100000011111100000000
000001111111111000111110000000
000111111111111111001110000000
000011111111011111111111000000
000000000111100000011111111000
000000001000110000011011111100
000000001000000000111001100100
000000000100000000110011000000
000000000110000001110011000000
000000000011000011100010000000
000000000001111111000000000000
000000000000011100000000000000
001110011110000001111001111000
000111100111101110011110011110
001011111011110111100111100110
000000000000000000000000000000
000000000000000000000000000000
000000000000000000000000000000