000000000000011111000000000000
000000000001111111110000000000
000000000011111111111100000000
000000000111011111111110000000
000000011110000101010011000000
000000011110000001001001000000
000000011111010010000011000000
000000111111110010101011100000
000000111111111111111111100000
000000111111111111111111100000
000001101011111111111111110000
000001101011111111111111110000
000001101011111111111111110000
000001001001111111111111111000
000001000011100001011011111000
000001000000000000000011111000
000001000000000000000011111000
000001000100000000000111111000
000001100100000010000111111100
000001110110000000001111111100
000001110010000110011111011110
000000111011100000111111001110
000000110011110001111111001110
000001110011111111111111100110
000001100111111111111111100110
000011000111111111111111100110
000111001111111111111111110010
001010001111111111111111110011
011110011111111111111111110011
010100011111111111111111110011