000000000000000000000000000000
000000000000000000000000000000
000000000000000000000000000000
000000000111111100000000000000
000000011111111110010000000000
000000111111111111111000000000
000000110011111111111000000000
000001110011111111110000000000
010001111111111111100000000000
011111111111111111100000000000
011111111111111111100000000000
011111111111111111000000000000
001111111111111110000000000000
000111111111111110000000000000
000000111111111100000000001100
000000111111111110000000011101
000001111111111111111100111111
000001111111111111111111111111
000011111111111111111111111111
000111111111111111111111111110
000111111111111111111111111110
000111111111111111111111111100
000111111111111111111111111000
000111111111111111111111111000
000011111111111111111111110000
000011111111111111111111100000
000001111111111111111111000000
000000111111111111111100000000
000000000000000000000000000000
000000000000000000000000000000