000000000000000000001111110000
000000000000000000011111111100
000000000000000000111111111100
000000000000000000111111111110
000000000000000001111111111110
000001111000000001111111111110
000111111110000001111111111110
001111111111000001111111111110
001111111111000000111111111100
011111111111000111111111111100
011111111111111111111111110000
011111111111111001000110000000
011111111111100000000011000000
001111111111000111110001100000
001111111111001101011001100000
000111111111001001001000110000
000001111110001011011000110000
000000001110001011011000110000
000000001110001111111100110000
000000001111011100000110110000
000000001111010001110010011000
000000000110000011111000001000
000000000110000111111000001000
000000000100000011110000001000
000000000100000000000000011000
000000000110000000000000010000
000000000011000000000001100000
000011111001110001000111111100
000111010111111100011111101010
000101010111111111111110101010