101011001010000111111000000000
110001011100001111111110000000
010101010000111111111111100000
011101111001111111111110110000
001001100011111111111100011001
011011000111111111111101011011
010111001111111111011101101111
011110011111111110000101110011
011000011111111110110001000001
110000111111101110111100000001
110001111111101111011100000001
100001111111101111101110011001
100111111111000011111111001011
001111111110000111101101100010
011111111100001001101100110010
011111111101011001101100010110
011101111101010001100110001110
111101111101110001100010000000
111100111101110000110000000001
111000111011100000010100000001
111000111011100000000100000101
111000110111100000000101000110
111001101101110000000011011100
111101111000110000000000111001
110100110000011000000010011110
100100111000011000000001110100
110100011000001000100000111110
011100001100000000110001110111
000000001100000011010001011101
110110100100011101111101001101