000000000000000000000000000000
000000000000000000000000000000
001111111111111100111111111110
001000000000001111111111111110
001000000000111000000000011110
001000000001100011111110000010
001000000110001111000011110000
001000001100011000000000111100
001000011001110000000000011110
000001111111101100000000001110
000111000011111000000000001110
001100000000000000000000000110
001100000000011110000000001110
001000001111101111001000000010
001000111000001111111100000110
001001000111111111111100000110
000101111100000111111110001110
000111000000000000111111000110
000011100000000000001111001110
001000000000000000001111101110
001000000000000000000111101110
001000000000000000000111111110
001000000000000000000011111110
001000000000000000000011111110
001000000000000000000011111110
001000000000000000000011111110
001000000000000000000001111110
001111111111111111111110111110
000000000000000000000000000000
000000000000000000000000000000