000000000000000011111111111111
000000000000000010001111111111
000000000000000011000111111111
000000000000011111100111111111
000000000011110111100111111111
000000000110010001101111111111
000000001100111001001111111111
000000011000101100000111111111
000000111001100100000111111111
000001110001110000110011111111
000011110011111000000011111111
000111110111110001110011111111
000101110111110000101001111111
000101100111100000111000000000
000101101111010000011000000111
000101101110010000000000111111
000100101110000000000001111111
000100101110000000000001111111
000110111110010000011111111111
000111101111010000000011111111
000011100011100000000111111111
000011100001000000001111111111
110010100111000011111111111111
111010101001000001111111111111
001111101111111111011111111111
111111000100000000111111111111
111110000010000001001111111111
110110000011111110000111111111
001100000111111110000111111111
001100001111111111001111111111