111001111110000000000111110001
011100111001111110000001100111
001111100111111010000000101100
100111001111110111100000011001
110110001111101010110000001011
111100001100100100010000000111
111100001100000001110000000110
011000001111010000111110000010
001000000111110011100111000011
100000000001100100011111000011
110000000011111100111110000010
110000001111111000110000000010
110000011110111110111000000011
011000111110111111011100000011
011001111101111111111110000011
011001111101110111111111000110
011011111011100001111111000100
111011110111001110001110001110
110111101111111100000100011111
110111100000000011100100110011
110111110000001111100101111001
110111111111111111001111011100
110111111111111111111111001111
111111111011111111011111100111
111111110111111111011111111111
011111110111111110000000000001
000001111111111000011111111111
000000011111000111000011111000
110000011111111111100000000111
111100011111111101100000111111