000000000000000000000000000000
000000000001111100000000011000
000000011111100110000000111100
000000010011001111100000110100
000001111001111000100000111101
001111101100111011110000011011
011101100110111110011000010111
010000100010111111001000011111
010110110011111111101110111111
011111010111111111111111111111
000011110111110011111001110110
000001111111100001110000010000
000000011111100000110000011000
010000000011100000100000001000
001011000110110101100100011000
001111101100010111101001111110
000011101100011011011011110011
000000111001101111101111100001
001100011000100111111110000001
010110011100011111111100000001
010011011111111011111111100111
001111101111000110111001111110
000111111100011100010000001100
000000011110000001010000000100
000000110010000001011000000100
000000110001100011001000001100
000000110000111111100000001000
000000110000000001110000110000
000001100000000000111111100000
000000000000000000000000000000