000000000000000000000000000000
000000000000000000000000000000
000000000111111111111000000000
000000111000000000000111000000
000011000111111111100001110000
000100111111111110000000011000
001011111111110000000000000100
001101111110000000000000001100
001110000111100000000000111100
001101111000000000000111101100
001100110111111111111011001100
001010110011001100110011010100
001011001011001100110100110100
001111001100110011001100111100
001111111100110011001111111100
000111111111111111111111111000
000111110110101111110111111000
000011100011000110100011110000
000011110100010001110111110000
000001111110000100011111100000
000000111111101000111111000000
000000011111111011111110000000
000000000111111111111000000000
000000001001111111100100000000
000000011100000000001110000000
000000010111000000111010000000
000000001001111111100100000000
000000000110000000011000000000
000000000001111111100000000000
000000000000000000000000000000