000000000000000000000000000000
000000000000000000000000000000
011101110000000000000111100000
011011110000011110001100110000
111111101100110011001000010000
111111111110110001111000110000
111001111110011000101011100000
011001111100001100101000010000
111111110000011001111110010000
111111111100011011001001100000
110110111100001110001000111110
001111011000000010111110111111
001111001000011110101010111111
000110001100111111111111111111
000000000100111101111111011111
000000000100111110111110111110
000000000100011111000001111100
000111100100000111111111110000
011111110000000001111111010000
111000111000111011111110011110
110000011001110111111100000100
110000111011101111111011000100
110011110011011111110111100000
111000000111011111000111100000
011000001110011110000111100000
011100011100011111001111000000
001111111000011111111111000000
000011110000001111111110000000
000000000000000111111100000000
000000000000000000000000000000