110111111110001000011111111011
110111111100011100001111111011
000001111000001000000111100000
110111110000001000000011111011
100111100000001000000001110011
110011000000011100000000111001
110110000000111110000000011011
111100000000111110000000101111
111001000000011100000000100111
110011100000011100000001110011
100001000001011101000000100001
000001000011111111100000100000
000011100011111111100001110000
000111110111111111110011111000
000111110111110111110011111000
000011100111100011110001110000
010011100111100011110001110010
011011111111100011111111110110
011111111111111111111111111110
011111111111111111111111111110
011110111111110111111111011110
011100011111100011111110001110
011000001111000001111100000110
011000001111000001111100000110
011000001111000001111100000110
011111111111000001111111111110
0_261_262_263_264_265_266_267_268_269_2610_2611_2612_2613_2614_2615_2616_2617_2618_2619_2620_2621_2622_2623_2624_2625_2626_2627_2628_2629_26
111000011111000011111000011111
110000111110000111110000111111
111011111111011111111011111111