111111111110000000001111111111
111111111001111111110011111111
111111100011111111111100111111
111111000111111011111111011111
111100000111110011111111101111
111000001111100001111111110111
111000001111101101111111111011
110000001111011110111111111011
110000001111011110111111111101
100000001111001100111111111101
100000001111000000111111111110
000000000111100001111111111110
000000000011110011111111111110
000000110001100001111100111110
000000011001000000011001111110
000000001011111110001011111110
000000001111111111100011111110
000000001111111111010011111110
000000001110111111010011111110
000000001110111111011011111110
000000000110011110001111111100
100000000000110011000011111101
100000000001100001100001111101
100000000111100001111001111001
110000011111110011111100111011
110000111111111111111110110011
111001111111111111111111000111
111101111111111111111111001111
111110000000000000000110011111
111111100000000000001001111111