000000000000000000000000000000
000000000000000000000000000000
000000000000000000000000000000
000011111111110011110111101000
000000110000011100111101111100
000000011111000110001111111000
000000000100000011011111111100
000011101111111001111111111100
000111110001000000111111111000
001111110000111111111111011000
001111111111000001111111011100
011111011111111111111111001100
011110111111111111111111100000
011000111111111111111111100000
010000111111111111111111110000
010000111111111111111111111100
000000011111111111111111111110
000000001111111111111111100111
000000000111101111000001110001
000000000111001110000000010001
000000001110011110000110110011
000000001100011100000111100011
000000001100001100000000000000
000000000110000110000000000000
000000000010000011000000000000
000000000011000001100000000000
000000000001100000110000000000
000000000001100000110000000000
000000000000000000000000000000
000000000000000000000000000000