000000000000000001000000000000
000000000000000001100000000000
000000000000000001100000000000
000000000000000111110000000000
000000000000001111111000000000
000000000000111011111100000000
000000000001111111111110000000
000000000001111111111111000000
000000000000111111111111100000
000000111100011111111111110000
000001111110000111111111110000
000001100111000001111101111000
000000110011000001111001101100
000000000111000001100000101100
000000011110000001001000101100
000001111100000011000000100100
000111110000000111100000000100
000111100000011111111000000100
001111000001111100111000000100
001110000011111110010000000100
001110000111111111000000001100
001110001110011111110000001100
001110011100110011110000001100
001111011101111011000000011100
001111111101111000000000011100
000111111100111100000000111100
000111111110011110000001111000
000011111111001100000001100000
000001111111100001111000111000
000000111111111111111100011100