000000000000011110000000000000
011111111111110011111111111110
011111111111100001111111111110
011111111101000000111111111110
011111110001000000111111111110
011111100001100001111111111110
011111100011100011011111111110
011111000111111110011111111110
011111100011111100011111111110
011111100001111000011111111110
011111110011110000111111111110
011111110111000000111111111110
011111110100000000111111111110
011111100000000000011111111110
011111100000000000001111111110
011111100011000010000111111110
011111101110000111000011111110
011111011100001111100001111110
011111011100011111110001111110
011111011100011111110000111110
011110111110001111111000011110
011110111110001111111100001110
111100111110001111111110000110
100001111111000111111111000010
000011111111001111111111100010
001111111111110011111111110011
111110111111000111111111111101
011100011111111111111111111100
011110111111111111111111111110
000011100000000000000000000011