000110110000000000000011110000
001101101100000000000110111000
010101011010000000001110101111
010101111111000000001110111111
011111000111000000001110111111
101110000010000000000101110000
110110000000000000001011111110
011110000000000000001111100000
101110000000000000001111110000
110111011110000000010000010000
011011111111110000111111110000
110111111111101111111111111000
001110111111011111111111111000
000011111111111111111111111000
000011111111111111111101111000
000011111111111111111101111000
000011111111111111111101111000
000111111111111111111011111000
001111111101011111111011010000
001111111011101111110110110000
001111000111000001111101100000
001110001110000000111011100000
001100001110000000110001110000
001100000110000000110001110000
001100000111000000110000110000
001000000011000000110000111000
001100000001100000110000011000
001110000000111000110000011000
000110000000011000111000001100
000000000000000000011000001110