000000000010000000000000001100
000000000111000000000000001000
000000001111100000000000001100
001000011111110000000000000100
011100110000011000110000001100
011110001111100001111000001000
001111001111100011110000000000
000111101101100111100000001000
000011101101101111000011111110
000001110111011110000111011111
000000111010111100001101101111
000000011000110000011111110111
000000110111011000001000100000
000000100101001000001010101010
000000110111011000001010100000
000000011000110000011111100001
111110111000111011100000011111
111101110111011101111111111111
110011101111101110111110000000
000111101111101110000000001100
011111011111110111000000001100
011110111101111011100000000110
001100111000111011110000011110
000000111000111001100011100110
000000111000111000000001000110
000111000111000111000011101110
111111111111111111100011101010
111111111111111111110011111010
111111111111111111111111111111
111111111111111111111111111111