111111111100000000001111111111
111100111100000000001111001111
111000011100001100001110000111
111010011100011110001110000111
100000001100001100001100000011
100110001100001100001100110011
110100001100011110001110000111
111000001100011110001100000011
111000001100111111001001111001
111111111100000000001111111111
000000000011111111110000000000
000000000011010010110000000000
000011000011010010110000110000
000111100011000000110001111000
000011000011101101110000110000
000011000011101101110000110000
000111100011100001110001111000
000111100011101101110001111000
001111110011000000110011111100
000000000011111111110000000000
111111111100000000001111111111
111110111100000000001110111011
111111111100001100001110111011
100001000100011110001010101010
101100110100001100001010101010
101100110100001100001000000000
100100100100011110001101000101
110000001100011110001101101101
110000001100111111001100000001
111111111100000000001111111111