000000000000000000000000000000
000000000000000000000000000000
000000000000000000000000000000
001111111111001111111111111110
001111111110000111111111111110
001111111111100111111111111110
001111111111110011111111111110
001111110000010010000011111110
001111001111110011111100111110
001110111110011100001111001110
001101111001100001110011110110
001101110111011110011101110010
001011101111111111101110111000
001011011001111111111111011100
001010110010111111110011011100
000110100110111111100101101100
000101000000011111001101101100
000101111111111010000000101100
000101110111110001111111110100
000101110111111111111101110100
001001110010111111101001110100
001001111000010101000011110100
001101110100000000000111110010
001110111010000000101101110010
001111011101010101111011110110
001111100001111111100111001110
001111111110011111011000111110
001111111111100000111111111110
000000000000000000000000000000
000000000000000000000000000000