000000000000000000000000000000
000000000000000000000000000000
000000000000000000000000000000
001111101111101111111010110100
001111111111011101111111011000
001111110111011100111111111000
001111101110111011111111111100
001111011001100000111111111100
001111000011011110011111011100
001101000010101100010111010100
001100111000110000100111100100
001101100100000000000011100100
001111011100000000000110001100
001110101100000000000100011100
000111010100000000000000001100
001111100101100000000000001100
001011100111000000000000001100
000011100000000000000000000100
000011110000111000000010001100
000110111001100000000010001000
000000111101000000000110000000
000001100110011000001100000000
000000000011000000011100000000
000000000001100000111000000000
000000000000100111110000000000
000000000000011111110000000000
000000000000000000111100000000
000000000000000000011110000000
000000000000000000000000000000
000000000000000000000000000000