000000001110111111000000000000
000000111001110001110000000000
000001110000011000011000000000
000001101000000110001100000000
000011010010010000100100000000
000011010110110010110110001110
000110110101111011111010111010
000110110111001111001110101010
000110101100000011101110100010
000111101011110010000110100100
000111111110000001110110110110
000111010001110001101011111111
000011110011101001000011101111
000001111000000000000011000110
011101101000000011000010000000
110100100000001000110111011110
100110110100000111100111110011
110011111110000011001011100001
011011110011110000110011100001
001111000110111111110011100000
111110011110010000010011110000
010110100111001100110011110100
101101000011000111100001110011
001101000011000011111000111110
011101000011100110111111111001
011001001001110111111111111111
000001000111111111111111111100
000011111100111111011111111110
000010000011111111111111111111
000001111110011111110111111111