000000000000001100000110000111
000111000000010100001010001101
011111111000011101101110001011
111011111100000001100000000110
110011111110000000011011100000
110111111111100000110110110011
010111100000110001001100011011
000111011110011011011000001101
000010010111001000010000000110
011110110001111000110000000010
010110101010110001100000000110
010011100000100001001100001100
011001100100110001111000111011
001110110001110000110001100101
000111111111110001101011000111
001101111111101111001110111000
011000011110111001000001101100
010001000100010011000000000000
010001110000111111000011011011
010000011111101110000011111111
011000110011011000000011011011
001101110010011000000111011011
001111011110001100001111110111
001000110000000100111110101101
001001100100000101100111111000
001000000100000100000000000000
001100001101111100000111111000
110111111111111000011100111110
011001110011100000111001000111
111011110011110011110111001001