000000000000000000000000000000
000000000000000000000000000000
011111100000000000000000000000
111011110000000000000000000000
111111110000000000000000000000
111110000000000000000000000000
011101100000000000000000000000
111110000000000000000000000000
111100000000000000000000000000
111100011111111100000000000000
111101100111110111100000000000
111011011010001010111000000000
110110111101111101101100000000
010110111110111000100110000000
010111011101010111011011000000
011011011011101111011011100000
001011100111110011011101100000
000101110111101100100010010000
000010111011011111011101110000
000111011100111111011110101000
000111101111000111011110101000
000111000111111000001110011000
000011100011111111110001111000
000001100000111111111111111000
001111100000000111111111110101
011111000000000001100000001111
010100000000001111100000011110
000000000000011111000000000000
000000000000010100000000000000
000000000000000000000000000000