111111111111001111001111111111
111110000001011100011111111111
111000111100011000000000000111
110011111110011000001111110011
110111000011011100011111111011
110110000001001110011000011001
110110000000000111011000001101
110110000000000011011000001101
110110000000000011011000001101
110111111111100011011000001101
010011111111110111011000011001
000000000000110110011000110011
100000111110111111111000000000
100001111111111111110000011110
110011100011110011000000111111
111111000000110011110001110011
011110000011111111111111100001
000000000111111111011111000001
110011000110011011000000000000
100110000110111011111111110010
101100000110110001111111111011
101100000110110000000000011011
101100000110110000000000011011
101100000110111000000000011011
100110000110011100100000011011
110111111110001110110000111011
110011111100000110011111110011
111000000000000110001111000111
111111111110001110100000011111
111111111100111100111111111111