000000100000001000001110000000
000000111100001000011111000000
100000111110001001111111110000
111001111111001011000000011000
001101111110001110000000001100
000111111111001100000000000110
000001111110001001111000000110
100000111100001001101000000010
110000000000001000111000000010
011000000010101000000000000010
001100000011111001001110000011
000110000111111101101010000011
011111000011111110001110000111
110001100111111110000110001111
100000100011111111100000011110
100001100011111111111001110000
100111100001111111111111000111
101111100001111111111000011111
111110100000111111110001111111
111101110000011111100111111111
111011011000001111001111111111
110111101100000100011111111111
110110010100000111001111111111
110111011100001101100111111111
011111111000011110110111111111
001111110000111001010011111111
000111100000111101110011111111
000001000000111111100111111111
000001000000111111001111111111
000001000000011110011111111111