000000000000000011000000000000
000000000000000111100000000000
000000000000001111110000000000
000000000000000011111011000000
000000011111001111111111100000
000000111110011111111111100000
000001111100011111111111100000
000001111001111111111111100000
000001111111111111111111000000
000111111111111111111111000000
001111111111111111111110000001
001111111111111111111100000111
001111111111111111111011111111
000111111111111111111111111111
100011111111111111111111111111
100001111111111111100000111110
110001111111111111000001110011
111000001111111011000011000001
111100001111110111000111100000
111100011011100111001100110000
011111110001110010011000011100
000000100001111000110011111110
110001100000111001100111110111
111111011110000011000111100111
111010001111001111000111101111
000010001111011010001110001111
111110000111110011000000011111
111100000001100111100000011111
111100011111001111100000111110
110001111110001111100001111000