001110011100010001110011100111
001110011100010001110011100111
001110011100010001110011100111
001110011100010001110011100111
001110011100010001110011100111
001110011100010001110011100111
001110011100010001110011100111
001110011100010001110011100111
001110011100010001110011100111
001110011100010001110011100111
001110011100010001110011100111
000100001000010000100001000010
000100001000010000100001000010
000100001000010000100001000010
000100001000010000100001000010
000100001000010000100001000010
000100001000010000100001000010
000100001000010000100001000010
000100001000010000100001000010
111111111111111111111111111111
111000111111111111110011111111
111010111111111111101011111111
100011111111111111100111111000
101011111000111111101111111010
100011110011011110000011111011
111111001010011110101011100011
111111010010011110000011100011
111111010011111111101111100011
111110011111111110101111111111
111110011111111110001111111111