111110001100000000111110011111
111111011110000001100011001111
000001010001111111100011110000
000011011000111111110111111000
000110001100011111110111111100
000100000100001111100011111110
000111111100000111000001111111
000000000000000011000001111111
111111111111111111000001000000
111111111111111111000001000000
111111111111111111100011000000
011111111111111111011101000000
001111111111111110000000100000
000111111111111110000000100000
000011111111111111000001100000
000001111111111111111111110000
111111000000000011000001111111
111111100000000010000000111111
111111110000000100000000011111
111111111000000100000000010111
111111111100000100000000010011
111111111110000110000000110001
111111111111000011111111100000
111111111111100000000000000000
111111111111110000000000000000
000000000000001111111111111111
000000000000000111111111111111
000000000000000011111111111111
100000000000000001111111111111
110000000000000000111111111111