000000011111111101011110110000
000000111110100011110001011000
000011101011011110011111100110
110111011010111011111010111011
101110110011111111100101011100
100110110010000011111111110011
010111010010000000001111001110
001101010000000000000011111111
000101100000000000000000111001
000110100000000000000000001110
001111000000000000000000000110
001000000000001000000000000011
001100000010001100000000000001
001100000111000100000000000000
000100000110000100000000000000
000100000000000100000000000000
000100000000000100000000000000
000100000000001100000000000000
000100000000001000000000000000
000100000000011110000000000000
000100000000110110000000000000
000100000011100011000000000000
001100100010000011100000000000
001000110110000001100000000000
001100110100000000110000000000
000110000100000000110000000000
000011111000000000111000000000
000000000000000000011000000000
000000000000000000011000000000
111111111111111111011000000000