111111111111111111111111111111
111111000000000000000000000001
111110000000000000000000000001
111100000000000000000000000001
111000000000000000000000000001
111111111111111111111111100001
100000000000000000000011100001
100000000000000000000110100001
100000000000000000001100100001
100000000000000000011000100001
100000111111111111110000100001
100000100011111111110000100001
100000100011111111110000100001
100000100011111111110000100001
100000100011111111110000100001
100000100011111111110000100001
100000100011111111110000100001
100000100011111111110000100001
100000100011111111110000100001
100000100011111111110000100001
100000100011111111111111100001
100000100110000000000000000001
100000101100000000000000000001
100000111000000000000000000001
100000111111111111111111111111
100000000000000000000000000111
100000000000000000000000001111
100000000000000000000000011111
100000000000000000000000111111
111111111111111111111111111111