000000000000000000000000000000
000000111000000111000000000000
000000011111111110000000000000
000000100111111001000000000000
000000111111111111000000000000
000001100011110001100000000000
000001011101101110100000000000
000001010101101010100000000000
000001011101101110100001000000
000001100011110001100001110000
000011111110001111100001111000
000011111111011111000000111101
000010101011111111100000000101
000011111111111111110000000011
000001010111111111110000000111
000011111111111111110000011111
000010101111111111010000111111
000011111111111111010011111110
000011011111111110010111111000
000001111111111110111111100000
000001111111111101111111000000
000001111111100111110010011100
000000110100110111100110111110
000000100110111110001111011111
000000001111100000011011100000
000001111100000000111011100000
000011110000000000111001100000
011111000000000001100000110000
110000000000000000000000000000
000000000000000000000000000000