111111111111110111010111111111
111111111111101110110111111111
111111111111001100110011111111
111111111111011100011011111111
111111111111011110011000111111
111111111001111011001000001100
000000100111111001001011001001
111110001111101101111111100011
111111100001110111111011111001
101111110010111111110011111110
110011111011111111110111011110
110001111111111011111100111111
111000001100111100111010111110
011000011111000110011001111100
011000111111111111001111111001
101100111111110011100001110110
110111111111101001110000000001
111011111111000111110001000011
110111111111111111100011100010
110011111111111111000111000110
111011111110000110000001101100
110111110000111110000001111110
111100000111100000000011111111
110001111000001111000111111111
100111000011111111111110000011
111100011110000000111100000000
001001111000000000011000000000
001110110000000000001000000000
000001100100001001001001010001
000001000110001001011101010011