000111000000111100111110000000
001111100011111001111100000000
011111111111111011110000000000
111111111111110011100000000000
110011111001100111100000000000
110001110011100111000000000000
110000000111001111000000000000
100000001111011110000000000000
000000001111011110000000000000
000000001111011110000000000000
000111101111011110000000000000
001111111111011110000000000000
011100111111011110000000000000
010000011111011110000000000000
000000001111011110000000000000
000111001111011110000000000000
001111111111011100000000000000
011000111111011100000000000000
010000011110011000000000000000
000000001110111000000000000000
000000001101110000000000000000
000000011011100000000000000000
000000111111111111000000000000
000001111111111111110000000000
000011111111111111111100000001
000111111111111111111111000011
001111111000000011111111100110
011110000000000000011111111100
111100000000000000000011111000
110000000000000000000001110000