111100000011111100000000011110
000100001111111110000110111010
011111011110111111001001100111
000000011100000101101011011001
010101011000010000111111100101
010001001000000001111100111011
000101001010001001111101001101
010100011100011001110101000111
010100111110000011001101000000
010001110111111001111001000000
000011001100000000000001011100
010010011000000000100010011100
010110110011000000111100110110
000101100110000001110000100010
001111001100000001000000100010
111000011000000001111111111111
001000111000001001000000000001
111111011100000010000000000011
110010011111000111111111111111
100010011111111110111111111111
110110011111111110000111111110
011100001111111110001111111100
000000001111110010111111111000
111111111000010011111111110000
111111111000010111111111000000
011100010000101100000111000000
011100010001001000000111000000
111100010011101110000111100011
111100010000010001000111100000
000000011111111111011100011111