011111111111111111111111111111
100010011111111111111111111101
111000100111111111111111111001
111100000011111111111111100010
111110000001111111111111000101
111111000000111111111110001101
111111100001011111111100011011
111111100000011111101000110111
111111110000011111010000010111
111111111000111110110000011011
111111111100011101100000110111
111111111100001011000001101111
111100011100010111000011011111
111011110010101100000001101111
110011101101110000000001011111
110100110101000000001011011111
111011000110100001011110111111
111111000011101011111101111111
111111100001111111011011111111
111111110001111110100111111111
111111111100110100011111111111
111111111110111000011111111111
111111111111011000111111111111
111111111111011100011111111111
111111111110111000111111111111
111111111110110101111111111111
111111111101011111111111111111
111111111011101111111111111111
111111111101011111111111111111
111111111111011111111111111111