000000000000000000000000000000
000000000000000000011111100000
000000000000000000111111111000
000000000001111101111111111000
001111100110000010110001111100
011111111000000000100000111000
111111110000000000010000111100
111000100000000000000000111100
111001110000000000000001111100
110001000000000111110000111000
011010011110001111111000011000
011110111111001100011100001000
010000110010000111001110001000
001001100110000011001110001100
001001100100000010011110001100
001001110011111101111110000100
001001111101111100111110000100
001000111100111000011100001100
001000111000000000000000001000
001000000001100110000000011000
000100000001110110000000010000
000110000000111100000001100000
000001110000000000111011111000
000111111011000001110111111100
001111111101111111111111101100
001011111101111111111111111100
000011111100000000001111110000
001101111101111111110111110111
000000111100000000000000000000
000000000000000000000000000000