100010000110001001101111110000
100010101011001001101111111100
100010101111001001101111111110
100010010110001001101000000100
100010010000001001101000000100
100010111100001001101000000100
111110111100001111101001110100
111110011000001111101011000000
000011111111111000000110011110
000000000000000000000110110001
111101111101111100001111100100
111101100101100100010011110100
110111100111100101111010010100
110111100111100101000001100100
110100000101100100110011011110
100101100001100000001111000011
000001111001100111011001000001
011001001101101001110011011111
111001000101001111000110000000
111000101000011001111011000000
111100100100110011000011100000
011111111111100010000111110111
011111111111100110000111110000
011111111111100100000111110000
001111111111001100001111111000
001110001110001111111111101100
011011011011001111011010111111
010101110101000011111111111101
011011011011000100011111101001
001110001110000111110000001110