111111111110000000011111111011
111101110000000000000011111111
111111000000000000000000111111
011110000000000000000000011111
111100000000000000000000001101
111000000000011000000000000111
110000000000110000000000000011
110000000011100000000000000011
100000001111111000000000000001
100000000011110000000000000001
100000000111100000000000000001
000000000001111110000000000000
000000000011111000000000000000
000000000011111000000000000000
000000000101111100110000100000
000000001011111111000011000000
000000010111111110001100100000
000111111111111111111111000000
000000000000110000011101100000
100000000000011000001110000001
100000000000001100000101000001
100000000000011000000010000001
110000000000111000000001000011
110000000000000000000000000011
111000000000000000000000000111
011100000000000000000000001111
111110000000000000000000011101
111111000000000000000000111111
111110111000000000000011111111
101111111111000000011111111111