000000000000000000000000000000
000011111111111111111111110000
000010000000000000000000010000
000010000111111111111000010000
000010001100011110001100010000
000010001000001100000100010000
000010001000000000000100010000
000010001000000000000100010000
000010001111111111111100010000
000010001111111111111100010000
000010010000000000000010010000
001110010111110011111010011100
001110010100010010001010011100
001110010100010010101010011100
000110010100010011111010011000
000111011111111111111110111000
000010110101001100101011010000
000010011010111111010110010000
000010010101111111101010010000
000010010010000000010010010000
000010010010101101010010010000
000011111010010010010111110000
000010000110010010011000010000
000010111010010010010111010000
000010111010010010010111010000
000010000010010010010000010000
000111111111111111111111111000
000101111000000111100111101000
000001111000000011000111100000
000001111000000000000111100000