001110000111101111000000011100
010011000110101001000000111110
100000100011111010000001101111
111111101110001011100001011111
000000011000000001111001011111
000000110100000000001100111110
000001101100100010000111011100
001111000001100011000011100000
011000000000000001000000100000
011001100000000001000000110000
010001100000010011010000111000
010000000000110010010000101000
011000000001110110011000101100
001110000011101100111000101100
000011111111101001110001100100
011000001000011011000001000100
011100001111110011010011000100
001111000111100011110110000101
110011101110000001111100000101
111000011000000000000000001101
000011110000000000000000001100
000110010000000001111110001011
011100010000000011100000001110
111100011000000111000000001111
001101001000001100000011011111
011111111000001000000110011100
111111111100001000001100111110
111110111111001001000111110110
000001110111111101001111111000
011100001111111111111110000011