000000000000000000000000000000
001111111111111011111100011110
001011111111111111110001111010
001111000110111111100111110000
001110011111111111001111111000
001100111111111111011111001100
001100111111111110011100111000
001100111111110110111011110000
001110011111111110111111110010
001111000111111110100110011010
001111111111100000000011110010
001111111111101110000011100110
001111111111101110000011101110
001111011100000111000110100110
000111111101101101101111110110
001111111101111111101000100100
001111111101110111011100001110
001111100000011111011110111110
001110001110001100111110111110
001100111100000011111110111110
001001111100001111111110001110
001011110110111011111101101110
000011101111111001111000001110
000111101101101000000101111110
000111011101111101110101111010
001111011111001001110001111110
001101110010000011111111111110
001000100000111111111111111110
001100001111111111111110111110
000000000000000000000000000000