000000000000000000000000000000
000000000000000000000000000000
000000000000000000000000000000
000000000111110000000000000000
000000011111111100000000000000
000001111111111100110000000000
000011111111111110111100000000
000111111111111110111111000000
000111111111111110111111000000
001111111111111110111111100000
001111111111111110111111100000
001111100111111110111111100000
001111101111111100111111110000
011111111111111101111111110000
011111111111111101111111110000
011111111111111001111111111000
011111111100111011111111111000
011111111110000011111111111100
011111000111111111111111110100
011110000111111111111111110100
011110000111111111111111110100
011110000111111111111111110110
011100000111111111111111110010
011100000111111111111111110011
011000000111111111111111100000
011000000111111101111111100000
011001000111111000111111000000
001111000011110000011111000000
000000000000000000000000000000
000000000000000000000000000000