100010000000010001110011000100
100110010000101011011111000000
110011000100010010001001111000
101111101100000110101000001101
110110000110000101100100000100
110011101100001101110111000110
101110011111001011110010100010
111111010110011010010011010011
110111101111010010011011101101
011111111101110111111001110101
100110111110101111111100111111
000001101111111100100111111111
000000010110011100100111111110
000000000011101100111111111111
111100000110011111111111000111
111111000000000011000010010001
011111000000000001111000110010
010101100000011100001100011010
001010100000011011000100110111
001010111000001111100001111010
001001101110011000100010011111
011100011001010011100001110111
011111010001111101000011011100
001011110000011011000000110011
101001111100001110000111100110
011101001110100100001000101100
000111100111100110000001010111
100001110101111001000000000000
011100011110010111000000000111
000011000011110000000000111100