000000011111100000000000011001
000000111111111000000000110101
000001100111111110000000101010
000011111111011111100001100101
000111111111011111110001100001
000111111110111011011011100001
000000000000010111111101100001
000000000000001110110110000001
000000000000001111011110000001
000000011110001111101011000001
000000101011111111101111000001
000001010001111101110101100001
000000000000011101110111100001
000000000000000001110100100001
000000000000000000110111100001
000000000000000000110100100001
000000000000000000110111100001
000000011100011001101101100001
000000101110111101101111000001
000001010011111011011100000001
000000000001001010111111000001
000011111100000111111111100001
000111111111111111111111100001
001111111111111111110111100001
011100001111111111100011000001
011000000011111110000011000001
011000000000000000000010000001
011100000001111111000011111110
001111111111110001110000001011
000111111111000000011000000101