000000000000000000000000000000
000111000000000001110000000000
001101100000000011011000000000
001000110000000110001000000000
001000011000001100001000000000
001000001111111000001000000000
001000011111111100001000000000
001101111111111111011000000000
000101111111111111010000000000
000111111111111111110000000000
000111000111110001110000000000
001110000011100000111000000000
001110000001000000111000000000
001100001001001000011000000000
001100010101010100011000000000
001100011100011100011000000000
000110001000001000110000001100
000011100011100011100000010100
000000110001000110000000100100
000000011100011100000011100100
000000110111110110000110000100
000001110000000111001110000100
000001110000000111001111000100
000001111000001111011111100100
000001111000001111111111101100
000001111100011111111111111000
000001111111111111111111110000
000001110011100111111111100000
000000100001000011111111000000
000000100001000011111110000000