000000000000000001111100000000
000000000000000111110011100000
000000000001011111101111110000
000000000010111111011111111000
000000000110111110111100011100
000000001100111101111000000100
000000011101111101110000000000
000000011101111001100000000000
000000111001111011101000000000
000001111001111011101100000000
000001111011110011011110000010
000011001011110111011111000110
000010101011110111011110101110
000110011011110111011110111100
001111110011110111011111011100
011111110011110011011111011100
000111110011111011011111011100
011111110011111011011111101110
011111111011111011011111100110
001111111011111011011111000010
000111111001111011101111000000
000111111001111011101110000000
000011111101111011110110000010
000011111100111001111010000110
000001111110111101111100001110
000000111110111101111111111100
000000011111011101111111111000
000000001111001100111111111000
000000000011100110111111100000
000000000000111010011110000000