000000001010000000000000000000
000000101010011111111100000000
000001101101111111111111100000
000010110111111111111111110000
000110011110111101111001111000
001011011110111011111001111100
001101111110110101111111111100
010110110111010101111111100000
010011110111110101111111000000
011001110111110110111111110000
001101111011111011000000000000
000111011101110000000000000000
000011011111011100000000000000
000011101111011110000000000000
000011110010001110000000000000
000011111110000000000000000000
000011111110000000000000000000
000011011110000000000000000000
000101100011001110000000100000
001101111111011110000000110000
001010111111111100000000111000
000110111110110000000001101000
000101011001111000000011011000
000101001111111111111110110000
000011010111111010101111111100
000010110101110110111111110110
000000101101011111110000111010
000000001011000000000000001110
000000000010000000000000000110
000000000000000000000000000100