000000000000000000000000001100
000000000000000000000000011110
000000000000000000000000111110
000000000000000000000001100111
000000000000000000000011100111
000000000000000000000011111101
000000000000000000000111111111
000000000000000000000110011101
000000000000000000000110011111
000000000000000001101111111101
000000000000000001001111111111
000000000000000010001100111010
000000000000000010001100111110
000000000000000010001111110110
000000000000000010001111111100
000000000000000001001100101100
000000000001111001000100111010
000000000110000110100111110111
000000000100000001111011101111
000000000000000000101101011111
000000000111111100111110111111
000000111100111111011110011110
000011111100110011101101100000
000111001111110011110011110000
001111001111111111101011111000
010011111111111111011101111100
110011111111110110111100111100
111111111101011101111100011110
011101010111110011111100000110
000111111110000001111000000000