000010000000000001111110000000
001101000000000001111111100000
000010000000001000111111110000
000000000000110100111111111000
000011111100001001111111111100
000010011111000001001111000100
000011011111111101110000011100
000001111111111110111111110000
000000001111111110100010111000
000000000011111110011001001000
111111100000111111001000110000
101001000001111111111100010000
001111101111110001110000100111
011111101111111000000000101101
011111101011111110000001111101
001111111011111111000011111011
000100111001111111111111111110
000100101100111100111111111100
010110000110011001111011111000
110011100011000011110000000000
011100111111110001110000000000
111000000000011111100000000000
111110000000110001000000000000
011100100001100011000000000000
111111110011111110011111111111
000000000011111000000000000000
111100000011111110001111111100
001111111011111110000001111111
000000000001000101100000000000
111111110111111111001111111111