000000011001000011000000000000
000000001101100110001000000000
000001100111101100010000000000
000000110111111100110000000000
000000011011111101100000000000
000001101111111111000000000000
000000111111111110000000000000
000000011111111110000000000000
000000001111111110000000000000
000000011111111100000000000000
000000011111101100000000000000
000000111111101100000000000000
000000111110101100000000000000
000000111111000110000000000000
000000111110000110000000000000
000000011011000010000000000000
000000011100000011000000000000
000000011111000001000011110000
000000011110000000100111011111
000000001100110000011111111110
000000001111100000001111110000
000000000111000000111111110000
000000000011110000011111100000
000000000001101001001111100000
000000001111000011100111000000
000000111000000111110110000000
011111111111111111101000000000
111111000011111100000000000000
111110000000001110000000000000
111000000000000010000000000000