000000010000000000000000000000
000000011000000001111000000000
000000011100000010101110000000
000000010110000011111010011100
000000010011100011001110110110
000000010001111101001100111110
000000010111111110111100101010
000000111111111110111000111110
111111111111001111011000110010
110001111111011111011000110010
010011111111011111010011111110
011011111111011111010111111110
001111111111111010111111111100
000111111111011010111111111000
000111110011100010111111000000
000111001111100010111111000000
000110111110000010111111000000
000111111111111101111111000000
000011111111100011111111001110
000001111100111111111110011111
011100000011101111111111111011
010111111110000111111111110000
111101111100011111111100000000
101001110000011111111000000000
011111100000011111000000000000
010100000011111111100000000000
011100000111011111110000000000
000000000101110011111000000000
000000000111010011111000000000
000000000011111111110000000000