000000001111111111111000000000
000000011111111110001100000000
000000111111111111100010000000
000001111111111111110010000000
000001111111111111110011000000
000001110000000000000001000000
000001100000000000000001000000
000111111111111111111111111000
001111111111111111111111111100
000011111111111111111111110000
000000111111111111111111100000
000001111111000100011111100000
000001111100000100001111110000
000011111000000000000011111000
000111111000000000000011111100
000111111000000000000001111100
000111110011100000111001111100
000011110111100000111101111000
000001110000000000000001110000
000001110010000000001001110000
000001010010000000001001010000
000001010010000000001001010000
000001000000000000000000010000
000000110000000110000001100000
000000011000001111000011000000
000000001100001111000110000000
000000000110000000001100000000
000000000011000000011000000000
000000001111111111111100000000
000000111111110000111111000000