000000000000000000000000000000
000000000000000000000000000000
000000000000000000000000000000
000000000000000000000000000000
000000001100000000001100000000
000000001110000000011100000000
000000001111000000011100000000
000000011111000000111110000000
000000011111100001111110000000
000000011111111111111110000000
000000111111111111111111000000
001000111000111110000111000100
001101110001001100100011001100
000111110011101101110011111000
000001110111100001111011100000
001111110011101101110011111100
001001110001001100100011100100
000011111100011110000111110000
001110111111111111111111011100
000000111111110011111110000000
000000001111111111111100000000
000000000111111111110000000000
000000000000111111000000000000
000000000000011110000000000000
000000000000111111000000000000
000000000001111111100000000000
000000000011111111110000000000
000000000000000000000000000000
000000000000000000000000000000
000000000000000000000000000000