000000000000000000000000000000
000000000000000000000000000000
000000000000000000000000000000
000000000000000000000000100010
000000000000000000000000110110
000000000000000000000000110100
000000000000000000000000011110
000000000000000000000000011110
000000000000000000000000011110
000000100000000000000000111110
000101100010001010000111111100
000011001001001100001111111100
000111111111111110111111111000
000000001111111101111111111000
000000000000000011111111111000
000000000000000111111111111100
001111111111000111111111110100
000000011111110111111111011000
001111100000000111111111101000
000000000000000111111111100000
000000000000000111111111100000
000000000000001111111111100000
000000000000001111111111000000
000000000000011101111011000000
000000000000111100110011000000
000000000001111000110011000000
000000011111110001110011000000
001111111111000001111111111100
000000000000000000000000000000
000000000000000000000000000000