000011110000000000000000000000
000111111000000000011011000000
001110111000000110111011100000
001111111000001110111011100000
011011101000001110111011100000
010111001100011110111011101000
000110011100011101111011101100
001110111100011101111011101100
011101111111100101111011101110
011101111111111011110111101110
011101111111111101110111101110
011001111111111110110111011110
011011111111111110101111011100
000011110111111111011111011100
010111101111111101101110111000
011111101111110011110110111000
011111011111101110111001110000
011111011110011101111011100000
001111010001111011101011000000
001111011111100111011111110000
000111001100011110111111100000
000001100011111101111010000000
000001110111100010011100000000
000000111000011111100111100000
000000011111110111111001100000
000000001011111000111111000000
000000001010011111000110000000
000000001010000011111000000000
000001111111000000000000000000
000010100100100000000000000000