000000000000000011111000000000
000000000001111111111110000000
000000000000000111011111000000
000000000000000011111111100000
000000000000000011110011110000
000000111110000001100001111000
000011111111100000100001111000
000111111111110000100000111100
000111100011110001100000111100
000111000000111001000001111100
001110000000111001000011111100
001110000101111001000011111110
001111000011111001000011110110
011111000011011011000111101110
011111100011111010000111001110
011011100000110010000110011110
011011110000010010000110011110
011001110001010010000100011110
011101110001010010000000011110
011101110001000010000000011110
011100110001100110000000011110
011100010000100100000000011110
011100010000100100000000001110
011100000000100110000000000110
011100000000100011000000011111
011100000001100111111111111111
011000000011001111000111100000
011000001111100000001111000000
111111111011110000000000000000
001111011100000000000000000000