000000000000000000000000000000
000000000001111111111100000000
000000001110110011111110000000
000000110011001111111111100000
000001101100011001111111110000
000011010000110000011111111000
000110100001100000001111111100
000101000011110000000111111100
001101000011111000000011111110
001010000111111100000001111110
011010000111111110000001111111
010100001111111111000000111111
010100001111111111100000011111
011011110001111111100000011111
011110000000111111110000001111
010000000000011111111000001111
010000000000001111111000001111
010000000000000111111100000111
010000000000011011111100000111
011000000011111101111110000111
001111111111111110111110000110
001111111111111111111111000110
000111111111111110111111000100
000111111111111000011111001100
000011111111110000011111011000
000001111110000000011111110000
000000111000000000111111100000
000000001100000011111110000000
000000000011111111111000000000
000000000000000000000000000000