000000000111111111111100000000
000000011101010101010110000000
000000110111111111111111000000
000001111111111111101101100000
000011011111111111110111110000
000111111111111111101011011000
000101111111111110010111111100
001111111111111111000111110110
011111111111111111100111111111
010111111111111111100111111101
111111111111111111000111111111
111111111111111111000011111111
111111111111111110100011111111
111111111111111100111001111111
111111111111110000000001111111
111111111111000000000001111111
111111111110000000000001111111
111111111110000000000011111111
011111111100000000000011111110
011111111100001110000111111110
001111111100000100001111111100
000111111110000000001111111100
000011111111000000011111111000
000001111111100000111111110000
000000111111110001111111100000
000000001111100000111111000000
000000000111110001111100000000
000000000000011011000000000000
000000000000001110000000000000
000000000000000100000000000000