000000000000000000000000000000
000000000000000000000000000000
000000000000000000000000000000
011111111111111111000000000000
010000000000001001111111000000
010000000000011101010101111000
010000000000010101011001001000
010000000000011101011001101110
010000000000010101010101101010
010000000100000001000001011010
010000001110000001101011001010
010000011111000001101011001110
010000111111100001011101101010
010001111111110001011101010010
010011111111111001001001011110
010011111111111001001001111010
010011111111111001001101111100
010001111011110001011111110100
010000110101100001111111110100
010000001110000001111101010100
010000011111000001101001010100
010101000000000001001001011000
010111000000000001001001111000
010101000000000001001001101000
010111000000000001001001101000
010010000000000001001001110000
011111111111111111111111110000
000000000000000000000000000000
000000000000000000000000000000
000000000000000000000000000000