000000000000000000000000000000
000000000011100000000000000000
000000011111111111110000000000
000001111111111111111011100000
000001101110111111101111110000
000000110111001110011100110000
000111001011110001110011001000
001111110111111111101100011000
011111111111100101111001111110
010111111110111011101111111111
001001101101000110011111101111
011111110011111001110110010110
011111111111111111111001111000
001111110110111111111111111110
000011111001111010011111110110
000001111110000101101011101110
000000001101100011101100011100
000000000000100111000111111000
000000000000111110000000000000
000000000000011100000000000000
000000000000011100000000000000
000000000000001100000000000000
011000000000011000000011111111
011111100000011001111111111111
011111111100011011111111111000
001111111111011101111000000000
010000111110111100000011111111
011111000111000011111111111111
011111111001111111111111111100
000000000000000000000000000000