000000000001111111110000000000
000000000111000011111100000000
000000011100011111111110000000
000000111001111111111111000000
000001110111111111111011100000
000011111111111111111101110000
000111011111111111111110110000
000110111111111111111110111000
000111111111111111111111111000
001111111111111111111111111000
001111100011000001100011111000
000100000010000000100000011000
000011100010000000100001110000
000000011110000000111111000000
000000000010000000110000001100
000000000110000000110001111000
000000000100000000010011110000
011110011100000000010101100000
111001111000000000011101100000
100110011000001000001010111100
100011101000011100001011000010
000001111000011100011110111101
001110001100110110011001110111
011000110100100111011011100001
110111111101101101011110011000
101100011111011100111111101100
110000110111111110111001111110
100001011111111111110000001010
000001100001111111001100000110
000001000000000001111110000010