000000111011111110000000000000
000011110110010011000000000000
000111001100010001100000000000
001110011100101001110000000000
011111111101111101111111100000
011100111111111111111001110000
111001111100000011111100110000
111000111000000000111000110000
111100110011000110111001100000
111111110000000000111111011110
111000111000001100111000111111
011100011000111001110001110011
001110001110000011100001100001
000111111111111111111011001011
000011111111111111111111001111
000001111111111111111111000110
000000111111000111110011100000
000000111100000011111001100000
000000111000000001111001110000
000001111000000000111001110000
001111110000000000111110111000
011111110000000000111111011000
011111110000000000111111011000
011111110000000000111111011000
011111110000000000111111011000
011111110000000000111110111000
001111111000000001111110111000
000011111100000011111110111000
001111101111111111011111000000
011111100111111110011111100000