000001111000001100010000000011
000000111110000101111000000110
000000001111000111110000001110
000000000111101101110000011100
001110011011011110111100111100
011011110010111101110101111000
111110100000111011110001111000
011101110001110111110011110000
111101111001110111110111110000
101101111101110111100111100000
101101111110110111101111011000
000110111110111111000000001000
000111011110011110011111111100
100011100010010000111111111101
110011111110110001110000111110
011001111100100011101111101111
011100001001100011011111111110
011100001001000010111111111010
001110001001000111111111110110
001111001001001101111111001100
001111001001011000000000000000
000111101011010011111100000000
000111101010110111111110000001
000011101010101111100011000001
000011110110101111000001100011
000011110101101111000000000111
000011110101011111000000011110
000001111101011110000011111100
000001111101011110001111111000
000000111101011100111111100000