000000000000000000000000000000
000000100100000000000000000000
000000110110000000000000000000
000000110110000000000000000000
000111111110000000000000000000
000000111111000000000000000000
011111111111000000000000000000
011111111111100000000000000000
011111111111100000000000000000
011111111111100000000000000000
001111111111110000000000000000
001111001111111100000000110000
000110000111111111111111110000
000000000111111111111111111000
000000001111111111111111111000
000000001111111111111111111000
000000001111111111111111111000
000000001111111111111111111000
000000000111111111111111111000
000000000011111111111111111000
000000000011111111111111111000
000000000001111000001111111100
000000000001111000000111111110
000000000001111000000011101110
000000000001111000000011100111
000000000001110000000011100111
000000000001110000000111000111
000000000001100000001111000111
000000000011100000000000001110
000000000000000000000000000000