000000000000000000000000000000
000000000000000000000000000000
000000000000000000000000000000
001111111111001101111111111100
001111111111001100111111111100
001111111111000100111111111100
001111111111100100111111111100
001111111111100001111111111100
001111111111110011111111111100
001111111111110011111111111100
001111111111000001111111111100
001111111110010000111111111100
001111111100010000111111111100
001111111110000000111111111100
001111110111100000011111110100
001111110110000000011111100100
001111110100000000011111101100
001111100101100000001111001100
000111101111100000000110011100
000110101111101110000110011000
000110101111000011000110011000
001010011110000001100110110100
001010011110000000100110110100
000100011110000000000010101100
000100011110000000000010101100
000100011011000000000010101100
000101011000000000011100101100
000101111111111111111100101100
000000000000000000000000000000
000000000000000000000000000000