000000000001111111110000000000
000000001111111111111100000000
000000011111111000001111000000
000001111111111000000011100000
000011111101111000001000110000
000011111001111000001100011000
000111110101111000010110001100
001111110101111011111010000100
001111110000001110000010000110
011111111000000000000010000110
011111101000000000000010000011
111111101000000000000110000011
111111011000000000001111000011
111111011111101001111111000011
111111101110101001011111000011
111111101101000000110010000011
111111110100000000010110000011
111111110110000000111110000011
111111111011101110111100000011
011111111111001110011000000010
011111111111000100011000000110
001111111101101110110000000100
001111111101111111110000001100
000111111110111011100000011000
000011111111001000000000110000
000001111111111000000001100000
000000111111111000000111000000
000000011111111000011110000000
000000000111111111111000000000
000000000001111111110000000000