000000000000000000000000000000
000000000000000000000000000000
000111000000000000000000000000
001000100000000000000000000000
001010111111100000000000110000
001010000000000001100001010000
001011111111111111111111110000
001010000000000000000000010000
001010000001110000000000011110
001010111101110111111111011110
001010000000000000000000010000
001011111111111111111111110000
001111110111111010100000110000
001111000111111000100000000000
001110000011111111100000000000
000000000011111000000000000000
000000000111111000000000000000
000000000111111000000000000000
000000000001110000000000000000
000000000001110000000000000000
000000000001110000000000000000
000000000001110000000000000000
000000000001110000000000000000
000000000001110000000000000000
000000000001110000000000000000
000000000001110000000000000000
000000000001110000000000000000
000000000001110000000000000000
000000000001110000000000000000
000000000000000000000000000000