000000000000000000000000000000
000000000000000000000000000000
000000000000000000000000000000
000000000000000000000000100000
000011000000000000000001110000
000111110000000000000011111000
000110111100000000000111011000
000100011110000000001110001100
000100001111111111111100001100
000100001111111111111100011100
000110011111111111111110111100
000111111111111111111111111110
000011111111111111111111111110
000011111111111011111111111110
000011111111110001111111111110
000111111111100000111111111110
001111111111100000111111111110
011111111111100001111111111110
011111110110100001101101111110
011111111001100001110111111110
010111111111100001111111111110
011111111100000000001111111110
011101111000010010000111111110
010000001100001100001110000010
010000000100001000001100000010
010000000100001100001000000010
011111111111111111111111111110
000000000000000000000000000000
000000000000000000000000000000
000000000000000000000000000000