000000101101101101000000000000
000011111111111101100000000000
000101111011101111010000000000
001111111011101101111000000000
010110111011101101110100000000
111110111011101101111100000000
010111011101101101101100000000
110111011101101101011000011000
110111011101101101011000111100
011011101101101101011000110110
111011101110101101111100111111
111101110110110111111100011100
111110111011011111000110001110
010111011101111100111111001111
111011101110111011111111111111
101101110111110111111110011110
011110111011101111111101111111
001011001111011111111011111010
000111111111011111111011010101
000010110110111111111111101111
000001101110111110111111110101
000000111111111101101111111010
000000000001111011011011111110
000000000000111000110110111110
000000000000011110001101111100
000000000000001111100011111000
000000000000000111111111110000
000000000000000011111111000000
000000000000000000011000000000
000000000000000000111111000000