110100111110110011111110110110
001111001111100110110011001011
010011111011001101001101101111
110101110001101011011110100110
111011101011011010110010110011
110111001100010100100011010110
011101100110010101100010111001
000011100110011010100100101101
111000101110011010111011010100
011110001111010111100101101110
001111011111001100001000101011
001111111111101100000000110101
001111111111010101100011010101
100111111111011101110111010101
110111111111001101111111011011
101011111110011101110011011101
111001111110010101000101010110
001110111100110101001101100110
011011000110101101001001100100
110000110110010101001001101011
111011010011000101001100100110
011101101011001101000110101101
001111000011110101111110100111
110011110111100110111001110001
011001100110011110100000111011
001110111000011000000000001010
111111011101101000111100011100
011101100011110011111111001110
111011010110100111100110000111
101110001101001110011000000011