000000000000000000000000111100
000000000000000000000001100100
000000011111000000000011001110
000000111111100000110011011010
000000101101110001110110010010
000000000000111001100100100110
000100000000011001001101001110
000110100000011001101001011010
000111100000011001101001010010
000011110001111000101001000110
000001111011101000101011001100
000000011110111110101010011000
000000000011110011101111111100
000011111000100001111111111110
000111101111110011011111111111
000000000000011110011111111110
000011111111111100011111100000
001110000000001111111110000000
011000011111111111110011100000
110011100100011111110001111100
100110001000111111100000110110
101100011111111111111000110110
111111111110111110111111110110
001111110000111111011111110110
000000000000111111010111100110
000000000000011111011000000010
000000000000011110011100000011
000000000000001110001110000000
000000000000000110000010000000
000000000000000000000110000000