110000000000000000000000000000
111000000000000000000000000000
011100000000000000000000000000
011100000000000000000000000000
001110000000000000000000000000
001111000000000000000000000000
001111000000001111001111001111
011111000000001011111111111101
011111001101000101111111111001
011110010111110100111111110010
011110101111111011111111111110
011110011111111111111111111100
011111111111111111110111011000
001111111111111111100110011000
001111111111111111111111110000
000111111111111101111101110000
000111111111111110111111101000
000111111111111101100111010110
000111111111111101110010001001
000011111111111011110100001101
000001111111111111110100000100
000000111111111111101000000000
000001011111011111110000000000
000010011111011111010000000000
000010111110001111010000000000
000010111100001111001000000000
000001111110000111100100000000
000000011111100111111010000000
000000000111110011111110000000
000000000011110001111100000000