000000000000000000000000000000
000000000111111111100000000000
000000001111111111010000000000
000000011111111110101000000000
000000111111111110110100000000
000001111111111101111010000000
000011111111111101111101000000
000111111111111011111011000000
001111111111111011100110100000
001111111111110000011001100000
001001111111100111100110100000
001000011111101100001010100000
001000000111011000111010100000
001000000001111011111010100000
001000000000101011111010100000
001000000000101011111010100000
001100000000101011111011110000
001110000000101011111011110000
000111000000101011111111100000
000011100000101011110110000000
000001110000101011000011110000
000000111000110011111000001100
000000011100101111100111100100
000000001111111111000000011000
000000000111111100000000000000
000000000011101000000000000000
000000000011011000000000000000
000000000011111000000000000000
000000000011111000000000000000
000000000011111000000000000000