000000000000000000000000000000
000000000000000000000000000000
000000000000000000000000000000
000010010011000000000000000010
000010010111100000000000000010
000010010111110000000000000010
000011010111111000000000000010
000001010111111000111111000110
000001111111111111111111111110
000001111111111111111111111110
000001111111111111111111111110
000011100111111111111111111110
010111111111111111111111111110
011111111111111111111111111100
011111111111111111111111111000
011111111111111111111111110000
000011111111111111111111110000
000111110011111111111111110000
000111000011111111111000110000
000000000011111111110001110000
000000000011110111100011110000
000000000001110111100011100000
000000000001110011100000000000
000000000001100011100000000000
000000000011100011100000000000
000000000011100111100000000000
000000000011100111000000000000
000000000000000000000000000000
000000000000000000000000000000
000000000000000000000000000000