000000010001111111000100000000
000000011110000000111100000000
000000001100000000011000000000
000111001100110110011001110000
011111111001111111001111111110
111111111011111111101111111111
111111111011111111101111111111
111111111001111111001111111110
011111111000111110001111111100
000111110000011100000111110000
000000111100001000011110000000
000000101100000000011010000000
000000011110000000111100000000
000000011010000000101100000000
000000001000000000001010000000
000000001000000000001010000000
000000001000000000001011000000
000000001100000000011011000000
000000001100000000011011100000
000000000110000000110011110000
000000000110000000110011110000
000000000110000000110001111000
000000000111000001111001111000
000000000111000001111000111100
000000001100000000011000111100
000000001001000001001000000110
000000001001100011001000000011
000000001001100011001000000001
000000000110000000110000000001
000000000001111111111111111111