000000000000000000000000000000
000000000000000000000000000000
000000000000000000000000000000
011111111111000001111000000000
011111111110000111111100100000
011111111000011111111110100000
011111110000111111111110100000
011110000110001111111110100000
011110001100000000111110100000
011100011000000011011100100000
011110110000100011100111100000
011110100000100011001101110000
011110100000100010011000001000
011000100000100011100011111000
010001100000110010001100100000
010001111011011000111000100000
011001111111101111100000100000
011011111111110000000000100000
010011110001111000011100100010
010001100000111100000110100010
000000110000110010000010100110
001111111000011001000110100100
011000011000011001100100101100
010000001100001100100100101000
010011100110001001000010100000
010100110000001110011000100010
010110011100011100011100000110
001110001111111001111111111110
000000000000000000000000000000
000000000000000000000000000000