000000000000111110000001111111
000000111001100011111100111111
000011111101000000100110011111
000110100111101111110010001111
001101100000110000110011000111
011001100101100110011001000001
110011101111001111011001111100
110011001001011010111011000111
110010001001100101110011100011
110010001101110111100111110011
110010000100111111100111100001
110011000110011111011011000011
111001100010000110011011100111
011100100111000100111011001111
001111100011111001110111001110
001000111001110111110110001110
011000001111111111101111011100
010000000000011111011110011001
011111100000000000001000111001
010000110000000001000111110011
000000011110000011111110000111
100000000011111111110000001111
100000001111111111110000111111
110000011111011110111100001111
110000011111011110011111000111
111000011110001111000011100011
111000001100000111000001111001
111100001100000011100000000001
111110001000000000110001111111
111111101000000000010111111111