000000000000000000000111000000
000000000000000000011011011000
000000010000000000111110111100
000001111000001110111101111100
011011111101100111001111111101
111101111111110011110111110011
111111111111110001111011111110
111111111111110001111101111100
011111111111100001111110111100
011111111111100110101110111000
011111111100011111010111111000
001111111011011110111000110000
000111110111100111111011000000
000111110111111011110110000000
000011110111111011111110000000
000001111011111111111100000000
000000010011111111111100000000
000000010001111111111100000000
000000010001111111111010000000
000000010000111111111010000000
000000011001011111110010000000
000001001001101111100100000000
000001001001100010000100000100
000001101001110010000100001100
000001100101110010001100111000
000000110100111010001001111000
000000110100111010001011110000
000000111010111010011011110000
000000011010111010010111100000
000000011010011010010111000000