000000000000000000000000000000
000000000000000000000000000000
000000000000000000110000000000
000000000000000001111000000000
000000000000000001111000000000
000000000000000001111000000000
000000000000000000110000110000
000000000000000011110000011100
000000000000000111111000000110
000000000000001111111100000010
000000000000001111111111000010
000000000000000001111111111110
000000000000000001111101110010
000000000000000001111000000010
000001100000000001111000000110
000011111110000011111000011100
000111111111111111111000110000
001110111111111111111000000000
001100111111111111111000000000
011100111111111111110000000000
011101111111111111100000000000
011001111111111111100000000000
011011111100000111100000000000
010011011100100101100000000000
000111011000111101100000000000
000110011100000001100000000000
000110001100000001100000000000
000110001110000001110000000000
000110001110000000110000000000
000000000000000000000000000000