000000000000000000000000000000
111111111111000011111111111111
110000001111111001111111111111
110111100111111101111111111111
100111111011111110111111111111
001111111001110000001111111111
011111111100100000000111111111
001111111110100000000000001111
101111111111000000000011100111
110000011111100000000011100111
110011100011100000000011110111
101111111100110000000111111111
101111111111000100000111111111
101111111111100011100000111111
101111111111000001111110001111
110011111000000110111111100111
111000000111001111011111110011
111000000001111111101111111001
111000000000111111110111111101
110111100000010111111011111110
110111111000000111111011111101
110000011110000111111011111101
110000001111000011111000110011
110110000011100011111011001111
111111100011100000010111111111
111011110001110111101111111111
111001111001001111111111111111
111000011000111111111111111111
111001111111111111111111111111
111011111111111111111111111111