000000000000000000000000000000
000000000000000000000000000000
000000000000000000000000000000
000000000000000011100000000000
000000000000000110111111000000
000000000001111101011111110000
000000111101010110111111111000
000001111110000111111111111000
000011111110011111111111111000
000111111101110000000011111100
000111110000001110000001111100
000111100001111111111001111100
001111100011111111111000111110
001111000111100001111100111110
001111001111000000011100111110
001111001110000000111100111110
001111101110000001111100111110
000111101110000011011100111110
000111100111000010101100111110
000111110111100011011100111110
000011110011111100111001111110
000011111000111011100001111110
000011111100000000000011111100
000001111111000000001111111100
000001111111111111111111111000
000000111111111111111111110000
000000011111111111111111100000
000000000111111111111000000000
000000000000000000000000000000
000000000000000000000000000000