000000000000000000000000000111
000000000000000000000000011110
000001111000000000000011111000
000011111100111110011111110000
000010111111111111111111000000
001111111101111111111111111000
000011111110000011111111100000
000001110011111000001110000000
000001110000011110011000000000
000000111010110001110000111100
000000001101000011100011101000
110000000011111111000110101000
111000000001111001101001011000
001110000011000011001011011000
000011110110000110010100110000
000000011111011101111111000000
000000000100111111100000000000
000000000000000001111000000000
000000000000011111001110000000
000000000000110101000011100000
000000000000101101000010110000
000000000001001010000110010000
000000000001010010000101011000
000000000011111100001001101000
000000000000000000001011011000
000000000000000000001010101000
000000000000000000001110101000
000000000000000000000110110000
000000000000000000000011010000
000000000000000000000000111000