000000000000000000000000000000
000000000001111111100000000000
000000001111101110111100000000
000000111111110001111110000000
000001100111100000111111100000
000011001111111111111111110000
000110001111010001011111111000
000100011111010001011111111000
001100011111010001011111111100
001000011111100000111111111100
011000001111110101111111111110
010000001111110101111111111110
110000000111111111111111111110
100000000011111111111111111111
100000000000111111111111111111
100000000000000011111111111111
100000000000000000111111111111
100000000000000001001111111111
100000000000000010000111111110
110000000000001101110111111110
010000000000011111100011111110
011000000000111111000011111100
001100000000111111100001111100
000100000000111111111001111000
000110000000011111110001111000
000011000000001111100011110000
000001100000000000000111100000
000000111000000000001111000000
000000001110000000011100000000
000000000011111111110000000000