000000000000000000011110000000
000000000000000001110000000000
000111100000000011000000000000
011111111000000110000000000000
111111111000001110000000000000
111111111100001100000000000000
111110011100011101111111111111
111110001100111111111111111110
110111001111111111100000000000
110011101111111111111111100000
011001111111111111111111111111
001111111111111111111100111111
000111111111111110001110000000
000011111111111111100111100000
000000111111101111110011111000
000000011111100100111001111100
000000001111110110011100011111
000000001111110011001110000000
000000001110111011000111000000
000000001110111001100011100000
000000001110011100110001111110
000000001110011110111000111100
000000001110001110011000000000
000000000111000111001100000000
000000000111000011100110000000
000000000011100001110011000000
000000000001110000110001000000
000000000000111000111000000000
000000000000011000011000000000
000000000000001000011000000000