000000000000000000000000000000
000000100000000000000000000000
000001100000000000111111000000
000001100000000011111110000000
000011100000001111111110000000
000011110000011111111100000000
000011110001111111111100000000
000011111001111111111000000000
000011111001111111110000000000
000011111000111111110000000000
000011111100111111100000000000
000011111110011111000000000000
000011111110011111000000000000
000011111111001110000000000000
000000001111101110000000000000
000000000011101110000000000000
000000000001111110000000000000
000110000000111100000000000000
001111111111111111110000000000
111111111111111111111000000000
111100000111111111111110000001
000000000001111111111111000001
000000000001111111111111100001
000000000011111111111111110011
000000000011011011111111111111
000000000110011011111111111110
000000000000010011011100011100
000000000001110011000110000000
000000000000000110001110000000
000000000000000000000000000000