000000000000000000000000000000
000000000000000001110000000000
000000000000000011110000000000
000000000000000011110000000000
000000000011000011110000000000
000000000011000011110000000000
000000000011000001110000000000
000000000011101111111100000000
000000000001111111111110000000
000000000001111111111111000000
000000000001111111111111110000
000000000000001111111111111000
000000000000001111111101111100
001110000000000111111000011100
011111000000000111111000001100
011111000000001111110000001100
011111000111111111110000001100
001110001111111111110000001110
000000011111111111100000001110
011000111100001111100000001100
011101111100000111100000000000
001111110000000111100000000000
000111000000000011100000000000
000011000000000011111110000000
000000000000000001111111100000
000000000000000001111111110000
000000000000000000000001110000
000000000000000000000001100000
000000000000000000000001100000
000000000000000000000001000000