000000000000000000001100000000
000000000000000000111000000000
000011000000000001111100000000
000001110000000011111000000000
000000110010000111111000000000
000000011110001111111100000000
000000011110001111111000000000
000001010111101111110000000000
000001110111100111110000000000
000011110011100111110000000000
001111111011110111100000000000
001111111001110111100000000000
001101111001110111000000000000
000001111100110110000000000000
000001111111111111111111000000
000001111111111111111111100000
000001111111111111111111100000
000001111111111111111101110000
000000111111111111111101111000
000000111111111111111101111100
000000011111111111111001111110
000001111111111111111000111100
000001111110000111111100000000
000001100010000011011110000000
000001111011000011000110000000
000000111011000011000011000000
000000000001000011000011000000
000000000001100110000001100000
000000000001100110000001100000
000000000001100110000001100000