000000000000000000000000000000
000000000000000000000000000000
000000000111100000111100000111
000000000100010000010010111000
000011111011011001100011100001
001111111011001010001010010001
011111111100011001111100111111
011111111110010000011111110011
000010011110100000000000000011
000011010010101111111111000011
000111110010111000111100110011
000111011010000000000000011011
001111011001000000001010001111
001101111001110000101010011111
001010111100111111101010110011
011101111100011111101010100111
011111111100000000101011100101
011111011100000000111111000111
011110101100000000111110000011
001111011000000000011000000011
000111110000000110010000011111
000000000000001111000011111111
000000000000111001110110100001
000000111100100000111110111001
010001110111110001100010101101
010011111011011111000100100111
010100001000010000010000100011
011111111111111111101111101111
000000000000000000000000000000
000000000000000000000000000000