000000000000011111111100000000
000000000001111111111111000000
000000000111111111111111110000
000000011111111111111111111000
000000111111111111111111111100
000001111111111111111111111110
000011110111111111111111110110
000011110011111111111111100111
000111101101111111111111011011
000111101110011111111100111011
000111101111000000000001111101
001111101110101000001010111101
001111001111101010101011111101
011111011111111010101111111100
011111011111111110111111111110
011111011111111110111111111110
100111011111111111111111111110
110111011100000111110000011110
110111001111110011100111111101
110111101111111011101111111101
110111101111111111111111111101
110010000111111100011111111000
111011110001111110111111000111
111001000000011100011100000000
111100111111100000000011111111
111110011110011110111100111111
011111000101111110111111011111
011111110011111110111111101110
001111111101101110111011101100
000011111101101010101011110000