011111000000000000000000000000
100111100011111000000000000000
111111101111110111100000111100
111111011111101101111011110011
111000111111011110001111111111
000000111111011110000111111100
000001111010111100000011000000
000001110001100000000001100000
000001110001100000000001010000
000000111011000111000001110000
000000011111000001000011100000
000000001111100111100110000000
000000000111111100111100000000
101111000010110000000001111110
000011111010100000110011111001
110111111111100001101011110111
000000011111111111011101111111
000000000010111111000100011100
000000000110000000001000000000
000000000100111111110000000000
000000001100000111100000000000
000000011100001101010000000000
000000111000001001010000000000
000000100011111011010000000000
001111100110011001011111111000
011001100000000001111111111100
111100010001110001000111100110
111111111111111111111000011111
000001111111111000000111100000
111111111000000111111111111111