000000000111111111110000000000
000000011111111111111100000000
000000111111111111111110000000
000000111111111111111111000000
000000111111111111111111000000
000000111111111111111111000000
000000111111111111111111000000
000000111111111111111111000000
000000111111111111111111111000
000011111111111111111111111110
001111111111111111111111111111
111111111111000000000011111111
111111110000000001111001111111
111111100111110011000101111111
111111110000011000000001111111
111101110011100001110001111110
011101100101010010101010111000
000110100011111011110010100000
000010000000001010000000100000
000011000000011011000001100000
000001100000000000000011000000
000000110110011011001110000000
000000010011111111110010000000
000000011001000000100110000000
000000001000100001100110000000
000000001100111110001100000000
000000001110000000001100000000
000000001011000000111110000000
000000011001100011100111100000
000001111100111110001111111100