000000111111111111111111000000
010011111010111110010011110010
001111101111101111111001111100
011111011111000111111101111110
011110111110000000001111011111
111101111000011111010111100111
111011110000101110000011100011
111011110001010111000001110011
110111101001000010000110111001
110111000000100100001100111001
011111000111111111111000111001
011110011111111111110001011101
001100111001111100000011011111
000101100001111000000111101101
001001100001111111011011100111
000001000011111111101110110111
000000011011110111111111011111
000111111111100001111111111111
101111011111100111100011101111
111110111101101001110001100111
111111110001111000111011001111
111111100111100000000110011111
110111001110000000001100011110
101100111100000000111000111110
011001101100000011100001111000
110011000110001111000011110001
110100000000111110000111000011
110100000011111000011110000111
101000001111000001111000101111
101111111000000111100011001111