000000000001111111100000000000
000000000011000000110011100000
000001110110000000011111110000
000111111100000000001111111100
000111111000000000000111111110
001111111000000001110011111111
001111111000110000011011111111
001111110011100000000011111111
001111110000000000011111111111
001111110001110000100011111111
001111110011011000111010111111
001111111010001000111010111111
001111111011101000111111011111
000111111011101000011101011111
000111111011111001110001111110
000111111101110011001001100110
000111111110000011111001000110
000011111111000001110011000110
000001110001110000000110001100
000000110000011111111100000110
000001111100000000000000000110
100011011000011111111111001110
100010011001111111111111111100
110010011111110100100000111000
110010001111010100100000000000
111010000010010100110000000000
111110100110010110011000000000
011111100110011010001000000000
001111100010001011111000000000
000000111111111000000000000000