000000000000000000000000011111
000000000000000000000001111111
000000000000000000000011100011
000000000000000000000110000011
111100000000000000001100000011
111111000000000000001100000011
110011100000000000011000000010
110001111000000000111000000110
110000011100011111111000001110
110000001111111111111110011110
011000000111111111111111111110
001000000111111111111111111110
001100000111111111111001111100
000110000111001111110001111100
000010001111000111110011111000
000011111101100111111101111000
000001111010111111111011111000
000000111011110111111011011000
000000111101101111111100111001
000000111110011111110011110001
000000011111111011111000110001
000000011011110001001100010001
000000011001100010111100010011
000000001100000011111000110011
000000011110000000110001100011
000000111011000000000111000111
000001100001101100111101001111
000001000000100111000011011111
000111011000110000001110011111
111110001110011111111110111111