000000110001101111011011000000
000000101010111100111111000000
000011111111110010010101110000
000011100111010101010111010000
001110011011010111001110111100
001100110101000010010101011100
110100111100010101111011001011
101110011001010101010110100111
110001100111101010000111101110
100110111110110101011011001011
001111010011110111010100100110
001011010111011111011110110001
100110010101011111101011011110
110000001010111111110110110110
001111001100101111011001111001
110001100110111111111001010110
101111111011011101110011100011
010110101001001001101101001101
010011100110111001010110101101
001100101011111001011100110010
011001101111011001001101011001
010111010110011001011010110101
101101001000111010010010111101
101111111111111011101011011011
110110011001111111101111000110
001000101111111111111110110001
101110011101111111111011111011
010111110001111111111000011110
111100000001111111111000000111
100000000000111111110000000001