000000000000000000000111100000
000000000000000000011111111000
000000000000000000111111111100
000000000000000001111110111110
000000000000000001011111001110
000000000000000000111111111011
000000000000000111111100011101
000000000000011111100110000101
000000000001111111110011101101
000000000011111111111001111101
000000001111111111111111110111
000000011111111111111101110010
000001111111111111110011011010
000011111111100111111110011010
000110110010000001111100110100
000001111111100000111111101100
000111100001111100001111011000
001100011110011011111100110000
011011100011100111100011100011
111110011111111000011110001111
111001110011010111110001111100
000011101100001101110111100000
000111011000000000111110000000
000110110000000011110000000000
001101100000011111000000000000
001011000001111110000000000000
011110000111001100000000000000
011100001110011100000000000000
111000011100011000000000000000
010000111000111000000000000000