000000000100000110000001100000
000000000100001011011010110000
000000001110001111011111101000
000000101010100111101101111000
000000011011000011111100110000
000000011111000101110101111000
000000111010100110001001011000
000000111110100011111011110110
000011101111011011011100101111
000101101111011101101111011101
000011111111111000001011010110
000100000000000100110110001000
000011111111111001111001101000
000011011011001001011011011000
000010010101011000110011111000
000011111111111000000001101000
010010111011101001000000001100
100110100110101100100000000100
011101110110110111000001100111
001011111001111010000110010100
001111111111111110011100110111
001011111001111010111100110111
010001110000110001111001111111
010101110010110101111001111111
010101110110110101111100000111
010101110110110111111111110011
011101110110111101111100000011
110011111111110001110000001111
111001110000110111000001111111
110111111111111100000000111111