000111011101110000000000000000
001111111111100110000010000100
001001111111011100000111001110
000011000111111100001111111011
000010000001110000011111110001
000111011100111100001111100001
000100110011011110011111000001
001000100001010000011110000111
001010101001010000111100000010
000100110010011001111000000011
011111111100011111111000000001
111111111110001111110000000001
000011001100000111000000000011
000110111000000000000000000111
000001111000000000000000001101
000011110000000000000000001001
000000110000000000000000011001
000000111000001000000000110011
000000111000001100000001100010
000000011000000100000011000110
000000001000000110001110001100
111111111100000011111000011111
111110011110000000000000111111
111000001111000000000011111111
110000001111100000000111111111
100110001111100111001111111111
100110011111001111100100111111
100000111100011111110001111111
110000111110000111111100001111
111111111000111111111001100111