111100111000111000011100111111
101000100111000111100100011010
111001000100111100100010001111
001001001000100110010010001000
111001001001000010001001001111
111001001001000001001001001111
111001001001000001001001001111
111101001001000001001001011111
111111100101000001011011111111
111111111100100010011111111111
111011111111100011111111001111
111001111111111111111111100111
110011000111111111111001100111
111110001100111110001000111111
111111111001100001001111111111
100111111111100001111111110011
100100111111111111111100100011
100100110011111111100100100011
100100110011000000100100100011
100100110011000000100100100011
100100110011000000100100100011
100100110011000000100100100011
110100110011000000100100100111
110010010011000000100100100111
001110001001100000111111111001
000101111000100011111110011001
000100010111100111111111101100
001100010010011111111111111110
001000110010001111100111111110
001000100010001111000011001110