011110111100000111111111111101
001101111110000111111111111101
111001111111000111111111111011
100011011111000011111111110110
000111101111100011111111001110
000111111111110001111000111100
000111011011011000111111111000
011111010011101110001111100000
011111111001110111000000000111
110111101001111011100000001100
100011101000111011110000111000
100001101100111101111100011110
110000101100011110111111000111
010000001110001111001111100001
011000111100001111110111110000
001100011110000101111101110000
000110001110001100111100111000
000111000110001110110100111000
000011100010011110011000111000
000011100000011111001011011100
000011100000011111100111001100
000011000000011111111111101100
000111000000011111111110001100
000110000010001111111101110110
001100000010001111111011111011
011100000110000111111011111101
011110000110000011110011011110
101110001111100011111011001111
011100011011110001111001110000
011000111001111110011110011110