000000000000000000000000000000
000000000000000000000000000000
000000000000000111110000000000
000000000000001111111100000000
000011110000011111111110000000
001111110000011111111111100100
011111110000011110111111111100
011000010000011011111000111000
110000011000001111110000000000
100000011000001111110000000000
000000001000000111100000000000
000000011000000001111100000000
000000011100000111111110000000
000000001100001111111111100000
000000001110011011111101110000
000000001111110011111100011100
000000001101110011111110001100
000000000100100011111110000100
000000000100000011111111000100
000000000100000011010111000110
000000000110000111010101100111
000000000110000110010100110011
000000000010000110110110110000
000000000010001110110010011000
000000000010001110111011001100
000000000011001110111111101100
000000000011001111110011100110
000000000001001100000001111110
000000000000000000000000000110
000000000000000000000000000000