000001111111111111111100000000
000111110011000110001111000000
001110011100000011000111100000
011111000110011001100111110000
111000110000001101101111111000
111100011110001101101011111100
111100000111100111011001111100
110000000001110010010000111110
100001000111100000000001111110
100011001111000111100011111110
001110011100001101000110111110
011100010100000000000000111110
011001010110000000111111111110
111001100110000011111111111110
110001100011000100011110111110
100001100011101000000100011110
101001110001111000000100011110
111000110100111100011111111110
011000111110011111110000111110
011100011110001111000001111110
001110010111000111100011011110
100110000111100111111111011110
110010000011110011111110011110
110011000001111001111110001110
110011100000110000011100001110
110011110000110001001100000110
111011111001111011001100000011
011001111001011111001000000000
001100111101001110001000010000
001100111110000100000000111000