000000000000000000000000000000
000000010101010000000000000000
000000011111111000000000000000
000000111111111100000000000000
000001111111111110000000000000
000001100111111111000000000000
000001000011111110000000000000
000001010011111111000000000000
000011100111111110000000000000
001111111111111111000000000111
111111111111111110000000001110
111111111111111100000000011111
011111111111111000000000111010
000011111111111000000001110111
000000001111111100000011100010
000000011111111111111111000111
000000111111111111111110000010
000000111110100111111111000111
000001111110100011111111100010
000001111101000001111111110111
000001111101000000011111111010
000001111101000000001111111111
000000111010000000000011111110
000000111010000000000000111100
000000011010000000000000001100
000000001111111111111111111000
000000000111111111111111100000
000000000011111111111110000000
000000000000111111111000000000
000000000000000000000000000000