111111111011111100011110111100
111111100111000001110011001110
000111011111111011001001100111
001100110000000010010100010000
111000011110000010000001111110
000000000111111011000000111111
000000000000000011110001000001
000000000000000010001110000000
000000000000000110000001000000
000000000000011100000001100000
111111111111111100000000111111
111100011111111110000000111111
100001111111101111000000101100
001111111111011111000000100000
110111111000111110000000100001
011011111111111110000001100011
100111001111111100000011000111
110001110111110000000110001111
111000001111100000011100111100
111100000000011111010001111000
111110001111000010100111100000
110011111100110010100000000011
001111100001100011111110000111
111111110011001110110011001110
111110011000011011110011000000
111001111100011111111110100000
100111111110011001111001100000
111111110011011110000010100000
111111001111111011111110100011
111100111111111001111110101111