000000000000000000000001100000
000000000000000000000111110000
000111000000000000001111110000
001001100110000000111111110000
001100101111100111111111111000
011101111111111111110111111000
011111011001111111100010111000
111110011000111100110010011000
101110011100011100010000001000
110010011110011000000000011000
101110001110111000000000011100
111100001111110000000000111101
110110000111000011100001111110
110011110111100111110000110110
110111111111110101110001100011
010111011100000100110000000010
011100101111100001110011001111
001001100111111101100111100100
001011101101110000000011001100
011011011011011110001110111000
010110011010110111000001100000
011000110110100111111111000000
011000110110001101110011000000
111100101110011100000011100000
101100100111010100101001110000
100100001111110011111100110000
100011111101110001101110110000
110110111000111000100111100000
011100000000011101100011000000
000000000000001111000000000000