000000000000000000000111110000
000000000000000000001111111000
000000000000000000011111111000
000000000000000000011111111100
000000000000000000111111111100
000000000000000001111111111110
000000000000000011111100111010
000000000000000011111011100111
000000000000000111111010100101
000000000000001111111000000001
000000000000001111111000101001
000000000000001011111100101001
000000000000011011111100000001
001111100001110011111110111010
011000011110000111111110000110
110000000000111111111111111110
100000000011111111111100100110
100000000011111111111000100011
100000000111111111111010101011
100000000111111111111000100011
100000000111111111111100000011
100000011111111111111110000111
100000000011111101111110000111
100000111111111101111110011110
110011101111100001111100011110
111100001111110000111111111111
111110000111110000111111011111
111111000111110000111100011111
111111000011111000111110001111
011101000011010100011111011110