000000000000000000000000000000
000000000000000000000000000000
011111111111111000111100000000
011111111111111001111100000000
011111111111111001111100000000
011111111111111001111000000000
011111110000000001111000000000
011111000000000011100000000000
011110000111111111100000000000
011100011111111111100000000000
011000111100001111110000111110
010001110000001111111001111000
010011111100011111011111110000
000111001100111111001111000000
011111100000111110000000000000
011111110001111100000000000000
011101110001111111000000000000
010000010001111111110000000000
010101110001110001110000000000
010000010001110000110000000000
011101010001110001110000000000
010000010001110001100000000000
011101110011100001100000000000
011111000111100001111000000000
000000001111000000000000000000
000000001110000000000000000000
000000000100000000000000000000
000000000110000000000000000000
000000000000000000000000000000
000000000000000000000000000000