000000000000000001111000000111
000000000000000011111100001111
000000000000000110111110011111
000110000000000110011110010111
001111000000001110001111010111
001111100001111101101111011011
011111110011111110011011001100
111111111111111101111001000111
111111111111111111111000000000
011111111111111111011000000000
011001111111111110111000000000
001100011011001110111000000000
000111010110110111110001110000
000011110101011111010111100000
000001110101111110111111111000
000011111111110111111101110100
000000111111001111111011001010
000001111111111011100110111010
001011111111110001000111111010
010100111101100000000011110100
010100011000001000000000001100
001000001100000111110000111000
001100001100000000011111101000
010100001110000011100001011000
010100011111000110111001111100
010100011111001011001111100100
110110111101001011110010110100
110010111100000001111000010110
111011111110000011111100010010
111111111111000000111100000011