000111111111101110001111111111
011111111100011111000111100011
111111111000111111100000011101
000011111100010101011100110000
011111110000010101000110110000
111101111111010001000011100000
111000111100010001000111110011
000000000000011111000000001111
000000000000111011100011111100
000000011101101100110011111000
001110111001111111110001111110
011111111001111000100000111111
000011111110110000100000001111
000000000000100101100010000000
000010000000100100100101111000
000100000000100000101101110100
000110000000110000111111100110
000101000000111100110111000001
001100100000111001000011001101
011111110000110001101101011101
000100000000100000101101011101
011111110001110000111111111110
100000001111011111100000000000
110000111101000000001111000111
111111110011110001110000111000
001111111111011110011100001100
110010111111101100110001100111
111111001111110001111011111000
111111100111001110001110001110
100111111111111111111111100011