000000000000000000000000000000
000000000000111000001110000000
000000000001111100011111000000
000000000001111111111111000000
000000000001111100001110000000
000000000001111000000011000000
000000000000110000000001000000
000000000001100000000001100000
000000000001000000000000100000
000000000001000000000100100000
000000000001000000001110100000
000000000001111000011110100000
000000000001111110110110100000
000000000011111111011101100000
000000000111111111100001100000
000000000101111111110011000000
000000001100011111111110000000
000000001000000111111100000000
000000011000000001111110000000
000000010000000000111110000000
000000110000000000011110000000
000000100000000000111111000000
000000100000000001111111100000
000000100000000011111111110000
000000100000000011111111110000
000000110000000011111111110000
000000011100000001111111100000
000111111111111111111111111100
001111111111111111111111111110
000000000000000000000000000000