000000001111111000000000000000
000000011111111100000000000000
000000011111111110000000000000
000000011000001111000000000000
000000011111110111100000000000
000000111111111011111111000000
000001110000011101111111110000
000001110000000111110011111000
000000111000000011100000111100
000000111111111101100011011110
000000011111111111110011111111
000000000111111111111001111111
000000000000001111111111111111
000000000000000111111111111111
000000000011111111111111111110
000000001111111101111111111000
000000111111111110111111000000
000001111111111111100011100000
000001111111111111111111110000
000011111111111111111111110000
000111111111001111111111110000
000111111111110111111111110000
011011111111110111111111100000
110111111111111011111111100000
110111111111111011110111000000
111011111111110111111011000000
011101111111101111110011100000
000001111110011011110001110000
000000011111100001111000111000
000000001111110000011100000000