000000000000000000000000000000
000000000000000000000000000000
000000000000000000111100000000
000111110000000001111110000000
001111111000000001111111000000
001111111011111011111111100000
001111110111111101111111100000
001111100111111100111111100000
001111101111111110111111100000
001111100101101100111111100000
001111110101101101111111100000
001111111111111111111111000000
000111110111111111111110000000
000011100111111011111100000000
000000001111110111110000000000
000000001101110111111111000000
000000011110001111111111100000
000000111111111111111111110000
000011111001111111111111111000
001111100001111111111111111000
001110000011111111111111111100
001100000111111111111111111000
001100000111111111111111111000
001111000111111100111111110000
000111100111110000011111110000
000011100111110000011111100000
000000001111110000111111000000
000000001111110000111111000000
000000001111110000111111000000
000000000000000000000000000000