001111111111111111100000000000
011111111111111111110000000000
111111111111111111111111110000
000000000000000000111111111000
000111111111111110111111111000
001000000000000110011111110000
011111111111111110000111000000
010000000000001110001111100000
010111111111101110000111000000
010100000000101110001111100000
010100111100101110000111000000
010100000000101110001111100000
010111111111101110000111000000
010000000000001110001111100000
010111111111101110000111000000
010100000000101110001111100000
010100111100101110000111000000
010100000000101110001111100000
010111111111101110000111000000
010000000000001100011111110000
011111111111111000111111111000
000000000000000000111111111000
111111111111111111111111110000
011111111111111111101111100000
001111111111111111000111000000
000000000000000000001111100000
000000000000001100011111110011
000000000000001111111111111111
000000000000001100011111110011
000000000000000000001111100000