000000000111111100000000000000
000000111111111111000000000000
000001111111111111111000000000
000011111111111111111100000000
000111111111111111111111000000
000111111110111111111111110000
000111111111001111111111111000
000111100111110011111111111100
001100111001111001111111111110
001111001110011000111111111110
011111110011100100011111111111
011100111100111000001111111111
011000011111001100000111111100
011000001111110110000011110000
011000001111110000000000000000
111000001110011100000000000000
100001001110001110110000000000
100011011100000011111000000000
000000011100000001001000000000
000001111100000011000000000000
000011111110000011000000000000
000011111110000001000000000000
000011111111000000000000000000
000011111111110000100000000000
000001111111111111100000000000
000001111111101111000000000000
000000111111100010000000000000
000000011111101100000000000000
000000000111111100000000000000
000000000001111000000000000000