000000000000000000000000000000
000000000000000011100000000000
000000000000000111110000000000
000000000000000111110000000000
000000000000000111110000000000
000000000000000111110000000000
000000000000000111110000000000
000000000000000111000000000000
000000000001111111000000000000
000000001111111111110000011100
000000011111111111111000111100
000000111000111111011101111000
000001110000111111001111110000
000011100000111110000111000000
000011100001111110000000000000
000000000001111100000000000000
000000000011111100000000000000
000000000011111111100000000000
000000000111111111111100000000
000000000111100000111100000000
000000000111000000011100000000
000000001110000000111000000000
000000011110000001110000000000
000001111100000011100000000000
000111111000000011100000000000
001111110000000001110000000000
001110000000000000111000000000
001100000000000000000000000000
001100000000000000000000000000
000110000000000000000000000000