000000000011111000000111100000
000000000110001111111100110000
000000001100110111111111011000
000000001001111111110011101000
000000001001100011111001101000
000000001011001111111111111000
000000011101111001111100110000
000000011001110110111011010000
000000011100111110111111010000
000000111000111001100011100000
000000111110011110000000100000
000000111110001100011110011000
000001111111100000011010011100
000001110011100000001100111110
000001111000110000011000111110
000001110100011100111101111111
000001111100110111000011101111
000111111010000011111111101011
011111111110000110100111011011
111101111101000000000111110011
111000111111011011001101100111
110001111111111110011101100111
110011011111111111111111011111
101110011111111111111111111111
111100011111100001111101111111
110000001111100001111101100101
000000001111110001111000101010
000000000111111011111000111110
000000000110101010101000000000
000000000011111011111000000000