011110000011111110000000111000
111111001111100011000001111000
111111011111110001000011111000
101111011100111000000111011000
001110111000001000000110011000
000110110000000000001101111000
110111101110000000011011011000
100111111111000000011011011000
110111110011011000111111011000
111011100001001100111101111000
111111000000000100101110110000
011111100100000110111110111110
001111100110000010111101111111
000001110011110010011111000011
000001110000011111011111111101
001000111000000011101111001101
001110111000000001111011110011
000111111000111110111110111111
000000011011110111101111111110
001100000111111111111011100000
011100001101111111111111100000
010100011011011011101110000000
110100111011100110101110000000
110000110111111110110111000110
111001100100011010110111001111
111001111111110011001111011001
011001111111000011111110010011
011100000000110001111100000111
001111110001111100000000111110
000001111111111110000111111100