100000000000000000001000011000
111000100000000000011000101000
011010110010000000101001001000
001111011011000001111111010000
001111111101100011101110011000
000110101111110110101011111000
000111000110111101001000111100
000111110011011011000000011100
001110111001101100100000001110
111100001100101000111100000110
011110000110111101011000001011
000111000011011001111000001011
000011110001001001110100011011
000001111000111100000000110111
000011011110000101000111101110
000110101111110110001111110110
000111000000011011110011101100
000110000001111000000111011100
000101000011001100000001101000
001110010000000100000011011000
001100110001110110000001110000
001100110011011111000010111000
001100110010000111000011111100
000100011010100011000111111110
000110011101110011001001101110
111111000111110001100000101101
111111000000110001111000010011
000011100000000011111100011111
110001111111000111111111111111
111100001111111111111111111111