000000000000000000000000000000
000000000000000000000000000000
000000000000000000110000000000
000000000000000000111111100100
000000000000000000111111111100
000000000000000000110011111100
000000000000000000110010011000
000000000000000001100110011000
000000000000000001111110111000
000000000000110001111111110000
000110000001110011111111110000
000111111111110011100011110000
000111111111110111100001110000
000011001100110111000001110000
000011001100110111001001110000
000001100100110111011101110000
000001100100110011111101110000
000001100110111001111111110000
000001110111111000111111100000
000001111111111000000000000000
000001111111011100000000000000
000001110111011100000000000000
000001110010011100000000000000
000001110000011100000000000000
000001111000011100000000000000
000001111100111000000000000000
000000111111110000000000000000
000000001111000000000000000000
000000000000000000000000000000
000000000000000000000000000000