000000000000000000000000000000
000000000011110000000000000000
000000001110011000000000000000
000000011000001100000000000000
000001110000000100000000000000
000001110000000110000000000000
000011111000000110000000000000
000011111000000110000000000000
000011111000011111000000000000
000000100001111111110000000000
000000000011111111111000000000
000000000111111111111100000000
000000000111001111111110000000
000000000110101111111110000000
000000000110011111111111000000
000000000111111111111111100000
000000000111111111111111110000
000000001111111111111111111000
000000011111111111111111111000
000000111111111111111111111100
000011111111111110011111111100
000100111111111000011111111100
000101111111110000011111111100
000111111001110000011111111100
000111111001110000111111111100
000111110011100000111111111100
000011100111100000111111111100
000000001111000001111111111100
000000000000000001111111111100
000000000000000000000000000000