000000000000000111110000000000
000000000000011111111000110000
000000000000111111111111111000
000000000011111110001111111110
000000000111111000000111111111
000000000111110000000001111111
000001111111000000001101111111
000111111111001100011101111111
001111111110011100011101111111
001111111111011100001101111111
011111111111011100000001111111
011111111111000000000001111111
011111111111000000101011111110
111111111111100001111111111100
011111111111111111111111111000
011111111111111111111111000000
011111111111001110111111100000
001111111111011111001111100000
001111111110111000011111000000
000111111000111000111111000000
000000000000111001111110000000
000000000001111001111110000000
000000000000110111111110000000
000000000000011111111110000000
000000000000011111111100000000
000000000000111111111110000000
000000000000111111111111000000
000000000001111111111111000000
000000000001111111111111000000
000000000000111111111110000000