000000000000000000000000000000
000000000000000000000000000000
000000000000000000000000000000
000000000000000000000000000000
000000111100000001111001100000
000001100110000011111111111000
000011101111000000111000011000
000101111111100000000011101100
000000111111110011110001100100
000000011100111110011100000000
000000010001111011000110000000
000000011111001101101011000000
000001101100011110010101100000
000011110001100111011010110000
000110011111001111001110101000
000101101000011101100011011000
001101011111110011110001101100
001101010100000111011110000100
001010010111011100111011110100
001010101101100001101100011100
001000101000111111011110000000
001101010000011101111111100000
000101010000010011110110110000
000110100000100110011011011100
000010100011101100001101100100
000001000101010100000110110000
000000000000000000000000000000
000000000000000000000000000000
000000000000000000000000000000
000000000000000000000000000000