000000000001111111111110000000
000000000011100000001111000000
000000000110001111100011100000
000000001100000001111001110000
000000001000000000111100110000
000000011000000000001110011000
000000011000000000000111011000
000000010000000000000011001000
000111010000000000000011001000
001110010000000000000001001000
001111010000000000000001011000
001111110000000000000000010000
000111110111100000000000110100
001011111110110001111000100100
001000111111110011101101101100
001100011111110011111101111100
001111011111110011111101111100
001111110111100011111111110000
001111111000000001111011000000
000011111100100100001111100100
000000111100011100111111111100
001110011000000000111111111100
001011011000001000110001110000
000101110000011000010111100000
000111110000111100011100111000
000111100001111110011111011100
000000000011100111001111101100
001000000111000011100111000100
001111111110000001110000001100
000111111100000000111111111100