000000000000000000000000000000
000000000000000000000000000000
000000000000001000001000000000
000000000000011000011100000000
000000000000010000111110000000
000000000000010000010100000000
000000000000000000010100000000
000000100000001000010100000000
000000110000101000010100000000
000000011000101000010100000000
000000001100000000010100000000
000000000111111100010100000000
000000000100000100010100000000
000000000100000100010100000000
000000011111111111111111100000
000111111111111111111111111100
000001000000000000000000010000
000001011111111111111111010000
000001010000000000000001010000
000001010100000000000001010000
000001010100000000000001010000
000001010000000000000001010000
000001011111111111111111010000
000001000000000000000000010000
000001111111111111111111110000
000000001110000000001110000000
000000001110000000001110000000
000000111110000000001111100000
000000111110000000001111100000
000000000000000000000000000000