000000000000000000000000000000
000000111111111111111111100000
000001111111111111111111110000
000011000000000000000011111000
000111111111111111111111111100
000000111000000000000011100000
000000111000000000000011100000
000000111000000000000011100000
000000111000000000000011100000
000000111111111111111111100000
000000111111000000001111100000
000011111001111111110011111000
000100111111111111111111100100
000111000000000000000000011100
000111111111111111111111111100
000100111111111111111111100100
000100100010001100011000100100
000100110010011100011000110100
000111111111111110111111111100
000011011111000011100011111100
000110001001000001100001000100
000111111001100001000001011100
000011000111011111000001101100
000111000100001111110011000100
000101111100001000011111000100
000100110111111000010001101000
000011100010001000010000111000
000001110010001100011001110000
000000011111111110111111000000
000000000000000000000000000000