000000000000000000000000000000
000111100000000000000110000000
000111110000000000000111100000
000100110000000000000111111000
000110110000000000001111111000
000110010000000000001110111100
000000010000000000001101110100
000000010000001111111011101100
000000010001111000011111011100
000000010011100000011110111100
000000010110000000111111111100
000000011100000011111111111100
000000011111111111111111111100
000000011110110110110110111100
000000011001001001001001001100
000000011111111111111111111000
000000001111111111111111110000
000000000111111111111111100000
000000000011111111111111000000
000000000001100000000110000000
000000000000100000000010000000
000000000000100000000010000000
000000000001110000000111000000
000000000011111000001111100000
000000000111011100011101110000
000000000110101111111010110000
000000000110101111111010110000
000000000111011100011101100000
000111110011111011101111011100
000000000000000000000000000000