000000000000000000000000000000
000000000000000000000000000000
000000000111100000011110000000
000000000100100001100111100000
000000001000010011011111110000
000000001000011111111111110000
000000001111110011111111110000
000000000011000001111111100000
000000001111110000011110000000
000000001111110000000000000000
000000000111100000000000000000
000000001000010000000000000000
000000010111101000000000000000
000000101111110100000000000000
000001011011111010000000000000
000001010111111010000000000000
000010110111111101000000000000
000010111111111101000000000000
000010111111111101000000000000
000010011111111001000000000000
000010011111111001000000000000
000001001111110010000000000000
000001100000000110000000000000
000000111000011100000000000000
000000001111110000000000000000
000000000111100000000000000000
000000001111110000000000000000
000000011111111000000000000000
000000000000000000000000000000
000000000000000000000000000000