000000000000000000000000000000
000000000000000000000000000000
000000011000000000000011000000
000000011111000000011111000000
000000111111100000111111100000
000001111111101110111111110000
000001111100000100000111110000
000001100101111111110100110000
000000001111101000111110000000
000000111101101110110111100000
000001111111101000111111110000
000011011111101011111111011000
000011111111101000111111111000
000111100111111111111111111100
000111111001111111111111111100
000100011110011111111111000100
000101011111100111111111110100
000100011111111011111111101100
000111011111110111111111110100
000100011111101111111111000100
000111111111011111111111111100
000111111110111111111111111100
000011111111110001111111111000
000011011111110111111111011000
000001111111110001111111110000
000000111101110101110111100000
000000001111110001111110000000
000000011111111111111111000000
000000111000111111100011100000
000000000000000000000000000000