000000000000000000000000000000
000000000000011110000000000000
000000000000111111000000000000
000000000001100001100000000000
000000000011000000110000000000
000000000010010001011000000000
000000000010111011101000000000
000000000010111011101100000000
000000000010111011101100000000
000000000110010001000100000000
000000000110000000000100000000
000000000100000000000100000000
000000001100000000000110000000
000000001100000000000011000000
000000011000000000000001100000
000000011000000000000000100000
000000010000000000000000100000
000000110000000000000010100000
000000100000000000000011100000
000001100000000000000011110000
000011100000000000000001110000
000011000000000000000000110000
000111000000000000000000111100
000111100000000000000000111100
000111001110000011000011111100
000111001111010111011111100000
000111111111111111111111100000
000111111111111111101111100000
000011101100111111000011100000
000011000000011100000011000000