000000000000000000000000000000
000000000000000000111000000000
000011111011111101111100000000
000111111111111111001100000000
000110011111111111001100000000
000110011111111111111100000000
000111111110111011111000000000
000001111111101111100000000000
000000011111111111110000000000
000000011111111111110000000000
000000011110000011110000000000
000000001100000000100001110000
000000011000000000111111111000
000000111000000001100011111000
000000111000000001000001111000
000000111000000000000000001100
000000111111000000000000000100
000001111111100000000000000100
000011011111100000000000000100
000011100111000000000000000100
000011111000000000000000001100
000011111100000000000000011000
000011111110110000001110110000
000011111111111000011111100000
000001111111111000011111000000
000000111111111000011111000000
000000011111111001111111000000
000000001111111111001110000000
000000000011110000000000000000
000000000000000000000000000000