000000000000000000000000000000
000111111111000110001111111000
000111111100000011000111111000
000111111000011001100111111000
000111111000001101100101111000
000111110000001101100100111000
000111110001111111111100111000
000111100011110010010010111000
000111000111100000000001111000
000100001111000000000000111000
000110001011000011110001111000
000110000011000001100000111000
000100100011000000010000011000
000000100011100000001111111000
000000110001110000000011101000
000000110101111010000001001000
000000111100111110000001001000
000000111110011110000011111000
000000011110001111001100010000
000010011110000111111000010000
000110010111000011111000110000
000110000111100001111111110000
000111000001110001111111100000
000111000001111001111111001000
000011100001110000011110011000
000001110100110000001100110000
000000110100110100000101100000
000010111100111100000100101000
000111111110011100001110011000
000000000000000000000000000000