000000000000000000000000000000
000000000000000000000000000000
000001110000000000000000000000
000011111100000000111110000000
000001111110000011111111000000
000010111110000111000001100000
000111111000000110111100100000
000001111100001101100010010000
000001011100001111011101010000
000000111100001110111111011000
000001111000000110100011101000
000011111000000111101100101000
000011110110000011111111011000
000110111111100011110011111000
000101101111110111111100111000
000101101111111111001110110000
000111110011111001101111010000
000011111100011101110101000000
000011111111111110110101000000
000001111111110110110110000000
000000011111111010100100000000
000000001101111001001000000000
000000001100111100000000000000
000000001000100000000000000000
000000010000100000000000000000
000000111000110000000000000000
000011100011100000000000000000
000110110110110000000000000000
000000000000000000000000000000
000000000000000000000000000000