000000000000000000000000000000
000000000000000000000000000000
000111111111000000000001111100
000111111100000000000000011100
000111111000000011111111001100
000111100000001111111111110100
000111100000111111111011111000
000111000001111111110001111100
000110000011111111111011110100
000110000111111111111111100000
000100000111111111111111110100
000100001101111101111111111100
000100001100111001111111111100
000000001100000001100011111100
000000001100101001001001111100
000000001100010001011101111100
000000001110000011011101111100
000000001111000011011111101100
000000001110000001001111000100
000100001110000000100111101100
000100000110000000110011111100
000110000110000000010011111100
000111000011000000010011111100
000111000001100000010011111000
000111100000100000000011110100
000111110000000000000111001100
000111111000000000000000011100
000111111110000000000001111100
000111111111110000001111111100
000000000000000000000000000000