000000000000000000000000000000
000000000000000000000000000000
000011111111100111111110000000
000011111111001011111111000000
000011111110011111111111110000
000011111100111110111111111000
000011111100101001101001111000
000011111000010111010110111000
000011100001101110110000111000
000011101111000001110110111000
000011110010000001110000111000
000011110010011000110110111000
000011110000111100110000110000
000011110100111100101101110000
000011110100011000100011100000
000011110110000000110111000000
000011110011000001101110000000
000011110011100011011100000000
000011100001110110110000000000
000010000000101101100000000000
000000111111011010111100000000
000001111110111101111111000000
000011000000111010001111100000
000011111110111011000111100000
000001111110111011001111100000
000000111110111100111111000000
000000000000011111111110000000
000000000000001111111000000000
000000000000000111110000000000
000000000000000000000000000000