000000000000000000000000000000
000000000000000000000000000000
000000000111111110000000000000
000000011110011111100000000000
000000111001101001110000000000
000000111011001110110000000000
000000110111011111111000000000
000010111111011011111010000000
000001110110110100111100000000
000000000111110110000000000000
000000001111010010000000000000
000000000001010010000000000000
000000000011010001000000000000
000000000010010001000000000000
000000000010010001100000000000
000000111100011000100000000000
000001110111001000110000000000
000011110011101000010111000000
000011111111101000111011100000
000011111111000001111110010000
000011111100111010011111010000
000001111011100111011111110000
000000011111111101111111110000
000000000111111100111111110000
000000000111111111111111100000
000000000111111111011110000000
000000000011111111000000000000
000000000001111110000000000000
000000000000000000000000000000
000000000000000000000000000000