000000000000000000000000000000
000111000000000011100000000000
000011111101111111000000000000
000011111111111110000000000000
000001111111111110000000000000
000000111111111100000000000000
000000011111110000000000000000
000000001111000000000000000000
000000001111000000000000000000
000000001111000001000000000000
000000001111000011000000000000
000000011111000111000000000000
000000011111100111000000000000
000000011111110111000000000000
000000011111111111100000000000
000000011111111111100000000000
000000011001111111100000000000
000000010000111111110000000000
000000011000111111111111000000
000000001000011111111111100000
000000001000111111100111110000
000000001100111111001111110000
000000000101111111111111111000
000000000111111111111111111100
000000111111111111001111000100
000000011111111000000000001000
000000001111110000000011110000
000000000000011100000001100000
000000000000000110000111000000
000000000000000011111100000000