000000000000000000000000000000
000000000000000000000000000000
000000000000000000000111000000
000000000000000000011111000000
000000000000000000111110000000
000000000000000000111111000000
000000011110000000001101100000
000000111111000000011111000000
000001100001100000011101000000
000000111111100000011110000000
000001111111100000011111000000
000011111011100000001111000000
000001111111000001110111100000
000001100111000011111111100000
000000011111100111111011100000
000000111101111111111011100000
000001111011101111100111100000
000001010111011000011111000000
000001010110110111111110000000
000000010110110011111100000000
000000000110100111111100000000
000000000011001111011100000000
000000000000011111011100000000
000000000000000010001100000000
000000000000000010000100000000
000000000000000110000110000000
000000000000000001100011100000
000000000000000010010011110000
000000000000000000000000000000
000000000000000000000000000000