000000000000000000000000000000
000000000000000000000000000000
000000001110000000000000000000
000000011100000000000000000000
000000111000000000000000000000
000001110000000000000000000000
000011100000000000000000000000
000011000000000000000000000000
000110000000000000000000000000
000110000000000000000000000000
000110000011111000000000000000
000110001111111110000000000000
000110111111111111000001000000
000011111111111111110001100000
000001111111111111111111100000
000001111111111111111111110000
000100111111111111111111111000
000000111111111111111111111000
000110011111111011111111110000
000011011001111011111001100000
000101111101100011110000000000
000000011111100111110000000000
000000000111100110110000000000
000000000001110110110000000000
000000000000011110110000000000
000000000000000111110000000000
000000000000000001110000000000
000000000000000000011100000000
000000000000000000000111000000
000000000000000000000000000000