000000000000000000000000000000
000000000000000000000000000000
000100000000000000000000000000
000110011100111011100110011100
000111111011111111001111111000
000011101111101111111111111000
000000100011000001111100111000
000000110001101110000011110000
000000111001110111101111100000
000001101100011101111011110000
000011100110101110011100000000
000011001011010000000000000000
000110101101001111100000000000
000111101111000100111100000000
000101101101000100000111000000
000011001100000100000001000000
000110100110001110000011100000
000111101010010101000101010000
000101101110101010101010101000
000011011100110101101101011000
000111011000101010101010101000
000111011100011101000111110000
000101111100011101000111010000
000011101000011111000111010000
000011110000011111000111110000
000011100000001110000011100000
000001100000000100000001000000
000000100000000000000000000000
000000000000000000000000000000
000000000000000000000000000000