000000000000000000000000000000
000000000010000011100000000000
000000100110000110010000000000
000000111110000110000000010000
000000111111000110010000111000
000000111111000011100000010000
000010011110000000000000000000
000111011110000000000111000000
000010011111000000000111100000
000000111111100000000011110000
000000111111100001000001110000
000000111111100001001000111000
000000011111000001011100111000
000000111110000001001000111100
000000111110000001000000011100
000001111110000001000000011100
000001111111000001000000011100
000011111111000001100000011100
000111111111100001100000011100
000111111111110001100000011100
000111111111110011110000011100
000111111111110011110000011100
000111111111110010010000111100
000111111111110110011000111000
000111111111100111111001111000
000011111111100110011011110000
000001111111001100001111100000
000000011111111111111110000000
000000000111111111111100000000
000000000000000000000000000000