000000000000000000000000000000
000000000000000000000000000000
000000001000000000000000000000
000000101100000000000000000000
000000111100000000000000000000
000000111111000000000000000000
000001111111000000000000000000
000001111111100000000011110000
000011111111100000000111111000
000111111111110000000111111100
000111001111110000111100011100
000000001111110001111110001100
000000001111111111111110001100
000000001111111111111111001100
000000001111111111111111001100
000000001111111111111111000100
000000011111111111111111000100
000000111111111111111111000000
000011111111111111111111000000
000011110011111111100111100000
000011000001110011110001100000
000011110000110000110001100000
000001110000110001110001100000
000000000000110001100001100000
000000000000110011100001100000
000000000000110011000011100000
000000000000110000000011000000
000000000001110000000000000000
000000000001100000000000000000
000000000000000000000000000000