000000000000000000000000000000
000000000001110000000000000000
000000000011111000000000000000
000000000001111111110011100000
000000000001111111111111110000
000000000011110111101111110000
000000000011111111111111100000
000001100011111000111110000000
000001110001111101111110000000
000000111001111111111110000000
000000011100111111111100000000
000000001110111111111000001100
000000000111111111100001111100
000000000011111111111111111100
000000000111111111111111110000
000000001111111111111111100000
000000001111011111111000000000
000000011111001111111000000000
000000011110001111111000000000
000000011110001111111000000000
000111111111011111110000000000
000111111111111111110000000000
000011111111111111100000000000
000000011111111111100000000000
000000001111111111000000000000
000000000111111110000000000000
000000000000001110000000000000
000000000000001110000000000000
000000000000001100000000000000
000000000000000000000000000000