000000000000000000000000000000
000000000000000000000000000000
000000000000000011001000000000
000000000000000011101100000000
000000000000000011101100000000
000000000000000011111110000000
000000000000000001111110000000
000000000000000001111110000000
000000000000000000111110000000
000000000000000000111111100000
000000000000000000011111110000
000000000000000000011111111000
000000000000000000111111111000
000000000011111001111111111100
000000001111111111111111111100
000000011111111111111111111100
000000111111111111111111111000
000001111111111111111111000000
000001111111111111111111100000
000001111111111111111111100000
000001111111111111111111100000
000001111111111111111111000000
000101111111111111111111000000
000111111111111111111110000000
000111111111111111111100000000
000111111111111111111110000000
000011111111111000011111000000
000000001111111100000111000000
000000000000000000000000000000
000000000000000000000000000000