000000000000000000000000000000
000000000000000000000000000000
000100000000100000000000000000
000100000000100000000000000000
000110000001110000000000000000
000010000000100000000000001100
000011000011111000000000011100
000011100000100000000000100000
000101110111111100011001111100
000101011111100000100100111100
000101100000100001111110111100
000110111110110000101100101100
000110111111011100101100101100
000111111111111111111111111100
000000000000000000000000000000
000000000000000000000000000000
000111111111111111111111111100
000001110110111111001111111100
000000110100011010110001111100
000000111100011010001110000000
000001111110011110000111111100
000000100100011010000010000100
000000111100011110000010000100
000000011000111111001111001000
000000011000010010001011101100
000000000000011110011110100100
000000000000001100010101101000
000000000000001100011011100000
000000000000000000000100000000
000000000000000000000000000000