000000000000000000000000000000
000000011111000000000000000000
000000111111100000000000000000
000001111111110000000000000000
000001101111110000000000000000
000011111111111000000000000000
000111111111111000000000000000
000111111111111100000000000000
000100011111111111000000000000
000000011111111111100000000000
000000011101111111110000000000
000000001101111111111000000000
000000001100111111111100000000
000000001110011111111100000000
000000000111000111111110000000
000000000111110001111110000000
000000000011111100001111000000
000000000011111111100011000000
000000000011111111111111100000
000000000011100111111111110000
000000000011100011100111111000
000000000011000001100111111000
000000000111000001100111111100
000000000110000001100011111100
000011111111100011100011111100
000000011100000011000011111000
000000110001111111000001110000
000000100000001111110000000000
000000000000011000000000000000
000000000000010000000000000000