00000000000000000000
00000000000000000000
00000000000100000000
00000000000110000000
00000000000111000000
00000000111111100000
00000001100100001000
00000011011100011000
00000011111100011000
00000011111000011000
00011111110011111000
00001110000001110000
00000110000000110000
00000010000000010000
00001000111110001000
00001101100111011000
00001011011111101000
00001101111111011000
00001000111110001000
00000000000000000000