00000000000000000000
00000000011100000000
00000000010100000000
00000000011100000000
00000000001000000000
00000011111111100000
00000011111111100000
00000000001000000000
00000000001000000000
00000000001000000000
00000000001000000000
00011110001000011100
00011100001000001100
00010100001000011100
00000111001001110100
00000011111111100000
00000001111111000000
00000000011100000000
00000000001000000000
00000000000000000000