00000000000000000000
00000000000000000000
00000000000111100000
00000000001111110000
00000000011111111000
00000010011111111000
00001010011110011000
00001110011111000000
00011111001111000000
00011111101111100000
00000111110111110000
00001111111011110000
00011111111101110000
00010011111111110000
00000001111111100000
00000001111111000000
00000001111000000000
00000011100000000000
00000000000000000000
00000000000000000000