00000000000000000000
00000000000000000000
00000000011100000000
00000000110010000000
00000001111111000000
00000000001000000000
00000000111110000000
00000011000111100000
00000100010001110000
00001101010101111000
00001000010000111000
00001011110010111000
00001000000000111000
00001101000101111000
00000100010001110000
00000011000111100000
00000000111110000000
00000011111111000000
00000000000000000000
00000000000000000000