00000000000000000000
00000000000000000000
00000100000001000000
00000100000001100000
00000100000000100000
00000100011000100000
00000110100101100000
00000011100111000000
00000001111110000000
00001111111111110000
00011011101111011000
00010011101111001100
00010011101111000100
00010011101111100100
00000011101110100000
00000010111100100000
00000110000000100000
00001100000000100000
00000000000000110000
00000000000000000000