00000000000000000000
00000000000000000000
00000000000111000000
00000000001101000000
00000000000001000000
00000000000011100000
00000000001111000000
00000000011111000000
00000000111011000000
00000000110011000000
00000001100111100000
00000001101111100000
00000011001111110000
00000011001111110000
00010011110011111000
00001100011111000100
00000111100010111100
00000001111111111000
00000000111111110000
00000000000000000000