00000000000000000000
00000000000000000000
00000000010000010000
00000000110000011000
00000000111111111000
00000000111111111000
00000001110111011100
00000001111111111100
00000001111111111100
00000000111000111000
00011000011111110000
00111100000111000000
00110100001111000000
00110100011111000000
00110000111111000000
00110001111101000000
00111111111001000000
00011111111001100000
00000011111101110000
00000000000000000000