00000000000000000000
00000000001111000000
00000000001011100000
00000000001001100000
00000000001100110000
00000000000110110000
00000000000011010000
00000000000001111000
00000111111000111110
00001111111101111011
00011111111111111111
00011111111111111110
00111111111111111000
01111111111111100000
01111111111111100000
01101111111111100000
00000111100001100000
00000011000001110000
00000011110000111000
00000000000000000000