00000000000000000000
00011110000000000000
00111111000000000000
00110011100000000000
00110001100000000000
00010001100000000000
00010001100000000000
00000001100000000000
00000001100000000000
00000011100000000000
00000111000000000000
00001110000000000000
00001111011111100010
00011111111111110110
00011111111111111110
00011111111111111110
00011111111111111100
00011111111111111100
00001111111111111000
00000111111111110000