00000000000000000000
00000000000000000000
00000000001111000000
00000000011001100000
00000000010000100000
00000000111000100000
00000000111000110000
00000001111100011000
00000011111110000000
00000111000111000000
00001100000011100000
00001100110000100000
00001100000110100000
00001110000000100000
00001111010101100000
00001111111111100000
00000111111111000000
00000011111110000000
00000000000000000000
00000000000000000000