00000000000000000000
00000000000000000000
00000000001000000000
00000000001000000000
00000000011000100000
00000000011000110000
00000110011111100000
00000011001111110000
00000001111110100000
00000000111100000000
00000001111001000000
00011111111111110000
00000111011110111000
00000010001110001000
00000010011100000000
00000000011100000000
00000000011100000000
00000000011100000000
00000000000000000000
00000000000000000000