00000001100000000000
00000011100000000000
00000011100000000000
00000011110000000000
00000001110000000000
00000001111000000000
00000001111100000000
00011111111110000000
00110001111111100000
00111110111111110111
00111110111111111100
01100001111111111100
01111110111111111100
01111110111111111100
00100001111111111100
00111111011111111100
00111110011111111100
00010001101111111100
00011111101111000111
00001111011000000000