00000000000011111000
00000000000111111100
00000000001111110111
01100000001110111111
11010000011110111111
11000000011110111111
11000000111110111110
11000011111110110000
11111111001110110000
01111111110001100000
00111111111111100000
00111111111111000000
00111111111110000000
00111111111110000000
01111111111100000000
11111101111000000000
11110000111000000000
11100000011000000000
01110000011100000000
00111000001110000000