00000000000000000111
00000000000000011110
00000000000001111100
00000000110111111000
00000111100111110000
11111101000111110000
00000111100111100000
11111111110111100000
00000000111111000000
00001100111111000000
00001111111111100000
00011111111111110000
00011111111111111000
00111111100111001100
00111110000011000000
01111000000001100000
01110000000000110000
11100000000000000000
11000000000000000000
10000000000000000000