00000000000011111000
00000000001111000011
00000000111100000110
00000001111000001100
00000011110000011000
00000111111000011000
00011011111100110000
00111101111110110000
01111101111111110000
11011101111111110000
11111101111111110000
11111101111111110000
01111101111110110000
00111011111100111000
00001111111000011000
00000001111000001100
00000000111100000111
00000000011110000000
00000000001111000000
00000000000011111000