00000000000000000000
00000000000000000000
00000000000000000000
00000000011100000000
00000000111110000000
00000001110111011000
00000011101011111000
00000111011101111000
00001110111110111000
00011101111111011100
00111011111111101100
00110111100011110100
00111111010101111100
00001111010101111000
00001111000001111000
00001111111111111000
00001111111111111000
00000000000000000000
00000000000000000000
00000000000000000000