00000000000000000011
00000000000000001101
00000000111000110001
00000000111101100010
00000000111111000110
00000000011110001100
00000111111100001000
00011111111000011100
00111111111110011110
00111101111111111110
01110001111111101111
01000011111111001111
00000011111110001111
00000111111110000111
00000111111100000110
00000111111100000110
00001111111000000110
00001111110000000100
00001111100000000000
00001110000000000000