00000001111110000000
00001111111111110000
00011101111011111000
00111111111111101100
01111111011101111110
11011111111111110110
11111111111111111111
11110000111100001111
11100001111110000111
01110001111110001110
00011111111111111000
00000001111110000000
00000001111110000000
00000011111110000000
00000011111110000000
00000011111100000000
00000111111100000000
00000111111100000000
00001111111000000000
00001111110000000000