00000000000000000000
00000000000000000000
00011100001100000000
01111110011110111000
11111110011111111100
00011110111111111100
00011111111111111110
00011111111111111110
00001111111111111110
00001111111111111111
00000111111111111110
00000001101101101110
00000001001100100100
00000001000100100100
00000001000101000100
00000010000101000100
00000010000111000100
00000110001110001100
00000000000000000000
00000000000000000000