00000000000000000000
00000000000000000000
00000000010000000000
00000000010000000000
00000000111000000000
00000000111000000000
00000001111100000000
00000001111100000000
01111111111111111111
00111111111111111110
00001111111111111000
00000111111111100000
00000011111111000000
00000011111111000000
00000111111111000000
00000111100111100000
00001111000011100000
00001100000001100000
00010000000000110000
00000000000000000000