00000011000011000000
00000011100111000000
00000001111110000000
00000011111111000000
00000111111111100000
00001111111111110000
00011111111111111000
00111111111111111100
01111111111111111110
11111111000011111111
11111111000011111111
11011111000011111011
00011111111111111000
00011111111111111000
00000011100111000000
00000011100111000000
00000111000011100000
00000111000011100000
00011101100110111000
00110000100100001100