00000000010000000000
00000000110000000000
00000001110000000000
00000001010000000000
00000011010000000000
00000010111111000000
00000111111111100000
00001111111110111000
00011111111111111111
01111111111111111111
10111111111111111111
10111111111111111110
10111111111110000000
10111111111111100000
10011111100000111100
11011111000000000000
11001111000000000000
11100110000000000000
11110010000000000000
11111100000000000000