00000010000000001000
00000110000000001100
00001110000000001110
00111110000000001111
01111100000000011111
01111000011110111111
01111101111111111110
01111111111111111100
00111111111111111000
00011111111111110000
00001001110011100000
00010011110111110000
00100111111111110000
00011011111111110000
00000001111111111000
00000000011111111100
00000000001111011100
00000000000111111100
00000000000011111000
00000000000001110000