11000000110000000110
11100001001111111001
11100001011111111101
11110001111111111111
11110000010111011100
01111000011001111100
01111100011001111100
00111100011001111100
00111100001111111000
00111110000111111100
00011100001111111110
00011011111110111111
00001011111001111111
00001100000111111111
00000111111011001111
00000011111000111111
00000001110111111110
00000001110111100000
00000000111000000000
00000000011110000000