00000000000000111110
01111111100001111110
11111111111101111110
01111111111111111110
00111111111111111100
00001111111111111000
11000000001111111100
10100000011111111110
10100000111111111111
11000001110011111111
10000001100011111111
10000011100011111111
00000011111111111111
11000111111111111111
10100111111111111110
10100111111111111110
11000011111111111110
10100001111111111100
10100000011111111100
11000000000011111000