00000000000000000000
00000000000000000000
00000000000000000000
00100000000000000000
00010100000000010000
00010111000000110000
00100111111111110000
00100111111111110000
00011110111111011000
00000110001100010100
00000111001100110100
00000111111111110000
00000111111111110000
00000110111111010000
00000011000000110000
00000011100001100000
00000001111111000000
00000000011110000000
00000000000000000000
00000000000000000000