00111110000000000000
01110011000000000000
01100000100000000000
01100000000000000000
01100000000000000000
01110000010000000000
01111100111000000000
00111111100000000010
00011111111111001111
00001111111111101010
00000011111111111000
00000011111111111000
00000111000000111000
00001100000011111100
00000100000010011110
00000000000111011111
00000000000010011111
00000000000000011111
00000000000000001111
00000000000000000111