00000000001100000000
00000001111111100000
00000000111111000000
00000000100001000000
11100001111111100000
11100001111111100011
01100011111101110111
01100011111100111101
01100011111100110001
01100011111100110001
01110011111100110001
01111111111100110001
00111111111100110011
00011111111100111110
00001111111100111100
00000111111100111100
00000111111101111000
00000111111111111000
00000100000000001000
00001111111111111100