00000000000011111111
00000000000111111111
00000000000111111111
01000000001111111111
01000000111111111111
01000111111111111111
11000000001111111111
10000000001001111111
10000000011110111111
10000000011111111111
11000000110111111111
01000001110111111111
01000011111111111001
00000011101111110011
11110000011111110111
11110000001111100111
11100000111011101111
01100001110111111111
01110001101111111111
00111111000111111111