00111000100001100001
01001000110001100011
01001000111011110111
01001000111110011111
01001000111110011111
11111100111111111111
10000100110000000111
00000000100000000011
10001000111000110001
10011100111101111001
10111110100100000001
10111110100100000000
10001000100110000000
10011100010000000001
10000000010111000010
10000000010010000111
10000000001000001111
10000000001100111111
10000000001111111111
11111111111111111111