00000011110000000000
00001111111000000000
00011111011100001100
00011110111111011110
00111100000001111111
11111111110011111111
11111111100111111111
11111111001111111111
11111110011111111111
11111110000000001111
11111100000000011111
01111111111100111110
00111111111001111100
00000011110111111000
00100010111111100000
00100010100010001000
00100010100000101000
00100000100010101000
00100010000010101000
00000010000010100000