11111011111110111111
11000000000000000111
11111101111011111001
11100000000000100001
11111101101111000001
11111111111100001101
11110000000100111101
11110111110100110101
11110100010100100101
11110100010100111101
11110100010100111101
11110110010100000001
11110100010100000001
11110100010100000001
11110100010111100001
11111111111111111001
11100111110011111111
11000111111000111111
11000111111000001111
10000111111100000011