00001111100000011111
00000001110000111111
00000000111000111110
00000000111100111110
00000000111101111110
00111100111011111100
11101110110111111100
00111110110111111100
11111111001111111100
00111111111011111100
00000111111011111100
00000111111001111000
00000011111100110000
00000011111111110000
00000011111111111000
00000001111111111111
00000001111111111111
00000000111111111110
00000000001111111100
00000000000000110110