11100111111111100111
10000001111110000001
01100000011000000110
01111000011000011110
01111110000001111110
01111111100111111110
01111111011011111110
01111111011011111110
01111111011011111110
01111111011011111110
01111111011011111110
01111111011011111110
01111111011011111110
01111111011011111110
01111111011011111110
10011111011011111001
11100111011011100111
11111001011010011111
11111110011001111111
11111111100111111111