01110000000001000000
11111100000001000000
11111110000001100000
10011111000001111000
00001111100011110100
00001111100011111110
00011111100011111100
00111111000001111000
01111110000011110011
11111100000111111110
11111100000111111100
11111100000111111100
11111110011111111000
11111110111111001110
11111111111110111111
11111111111101111110
11111111111111111100
01111110111111110000
00111100011111111110
00000000000111111111