00000000000000000111
00000111111111100111
00001110000111100111
00011100001110100111
00111111111100100111
01111111111000001111
01000000001011111111
01011111101011111110
01011111101011111100
01011111101010000000
01000000001000100000
01000000001000100000
01011111101000100000
01011111101000100000
01010000101001100000
01011111101011110000
01000000001111111000
01111111111110000000
11111111111110000000
11100000000111000000