00000000001111111100
00010000011111111110
00010000111100001111
00010000111000000111
00111000111000000111
00111000011100001111
01000100011111111111
01111100000111111111
01101100000000000111
11000110110000000111
11000110111000001111
11101110011111111111
11111110001111111110
11111111111111111111
11011101100111000111
11001001011010110111
11010101011010110111
11010101000011000111
11011101011010110111
11111111111111111111