11111111111110010011
10000000001100110010
10000000011001000100
10000000111011011001
10000001111100010011
11100011011110100111
10110110001111001101
10011100000111111001
10001000000011110001
11101000000001100001
11101000000011000001
10101100000111111001
10110110001100001111
10010011111011100001
10011100000000110001
10000111100000011111
11100001110000000011
10100000110011101101
10111000111110111101
11001110110000000111