00000011110001100000
00000111111110111000
00001111111111111100
00011111100011111100
00011110011111111110
00111001111111101110
00111111000110000011
00111110000100110001
00111000001001101011
00110000000101111001
00111101110010110010
00110001000100000001
01110000000011010111
01110001000001111101
01110011000001110111
01111000010001011111
01111011110011011111
11111100000011101111
11111110000111101111
11111111110001110111