00000000000011100000
00000111000001110000
00001111100000111000
00011001110000101100
00110110110000110110
01111110110111110110
01100011011111001110
01000011011100111100
00000001100011111000
00000011101011100000
00001111100011000000
00011110011101000001
00111001111101100011
00110111011110111111
00110110011010110110
00111010011011001110
00011110011001111100
00001111011000111000
00000111011000000000
00000000011000000000