00110000000000000110
01001000011100001001
00110000100110000110
00000001001111000000
00110001001111000110
01001011011111101001
01011111000111111011
01011101011111011011
01011001011111001011
01001001000111001001
01011001011111001011
01001001011111001001
01011011000111101011
01001111011111111001
01011101011111011011
01011001111111001011
01111001111111001111
01111000101110001111
00110001010111000110
01111011111111101111