00011110001111000000
01111111111101111100
11111111111011111110
11101111100111111110
01110011001110110011
01111001011110110111
11110000011111010111
11111110011111000111
11011111011111011110
11100111001110011110
11111001001100111110
01111100001011111110
00001111000011111100
00000011100111000000
00000000100100000000
00000000100100000000
00000000100100000000
00000000100100000000
00000011100111000000
11111111100111111111