11111110000011111111
11111100000001111111
11111000000000111111
11111000000000111111
11111000011000100001
11111100010000000000
11100000000001100000
11000000000001000000
10000000100000000000
10000000100000000000
10000000110011000001
10000000011110000111
11000000000000000011
11100001000000000001
11111111000100000001
11111111001100000001
11111110001110000011
11111110011111000111
11111100011111111111
11111000111111111111