00000000000000000000
00000000000000000000
00011111100000000000
00111111110000000000
01110001111000000000
11101110011100000000
11011011101100000000
11010100110110000000
11010111010110000000
11011011010110000000
11101110110100001001
01110001101111000110
00011111111111000110
00000001111110001100
01100011111111111100
00111111111111111000
00001111111111110000
00000011111000000000
00000000000000000000
00000000000000000000