00000000000000000000
00000000000000000000
00000000000000000000
00000001111111000000
00001111111111111000
00111001111111001110
00001110000000111000
00001111111111111000
00001111111111111000
00001111111111111000
00001111111111111000
00001111111111111000
00000111111111110000
00001001111111001000
00000100000000010000
00000110101010110000
00000001101011000000
00000000000000000000
00000000000000000000
00000000000000000000