11111110000001111111
11111000000000011111
11110011111111001111
11100111110001100111
10101101101010110101
10001110100000110001
11101111010101110111
11000000000000000011
10000110000011100001
10000100000000100001
10000100011000100001
00110010111101001100
01101001111110010110
01111000000000011110
00110011111110001100
11111110000011111111
10000010000010000001
11111111111111111111
01110000000000001110
01110000000000001110