00000000001111000000
00000000000011110000
00000001111001111000
00000011111000111100
00000111110000011110
00001111100000011110
00011111110000001111
00111111111000001111
00011100111100001111
00001000011110001111
00000000001111001111
00000000000111111111
00000110000011111110
00011111000001111110
00011111111111111100
00111110111111111110
01111110011111100111
11111000000000000111
11110000000000000011
11100000000000000000