00001100011000000000
11011110111101111000
11110011100111110000
11011110111110100000
01101100011101100000
00111110111111000000
00011111111111000000
00011000001111000000
00110000000111100000
00111100110111100000
00110010000011110000
00110010000011111000
01110011000001111110
11110000000011111111
10011011100111111101
10011100011111111101
10001110111110011001
10001111111100000001
11000111110000000011
11100011100000000111