00000000011111100000
00000000111111110000
00000000101110000000
00000000100100000000
00000000011111000000
00000000001111100000
00000011111110110000
00000111111111010000
00000110000111010000
00001111111110010000
00001101111111110110
00011000000111101111
00011000001111111100
00110000011111111000
00110000011100110000
01110000011000001110
11011000011000011011
10001110111001110001
11011001111110011011
01110000000000001110