00001100000000000000
00000110000000000000
00011110011000001100
00111100010100010100
00110000010011100100
00110000010111111100
00101110011100001100
01111111111000000100
11111111011010010100
11111111010000000100
11111111101000101000
11101111111101010000
11011111111111100000
11101101111011100000
01100110111101110000
01110000011110110000
00000000001110000110
00000000000000001011
00000011100000001111
00000000011111110110