00001111111111100000
00000101111111111000
00000010111111001100
00000010111111000110
00000010111111000110
00000010111111000110
00000010111111000110
00000111111111101100
00001100111111111100
00011001111111111000
00010011111111111000
00110011111111111100
00110011111011110100
00110001110001110100
00110100100100100100
00011011001110001000
00011001011111011000
00001100111111110000
11100111001111100111
11111001111110011111