00010111101000000000
00001110100000000000
01010100000000000000
00101000000000000000
01110000111100000000
01000001111110000000
00000010000001000000
11000111111111100000
10100100000000100000
01011111111111101110
01000000001111111111
00100000000111110011
00100000000011110011
00010000000011110110
00010000000011111100
00010000000111110000
11101000001111101111
01110111111111011111
10111000000000111111
11011111111111111111