00011110000000000000
01111111111100111000
11101111011111111100
11010111010101111110
11111100110110110011
11111001100010111111
11000001000010011111
00000011000001011111
00000010000001001111
00000010000001100011
00000110000000100000
00000100000000110000
00000100000000010000
00011101100011110110
00110111110110111111
01100111110110111111
01100111110111011111
01100111110111011111
00110011100011111110
00011111000001111100