01000000000000000000
01100000000000000000
01110000000000000000
01111000000000000000
01111100000000000000
01111110000000000000
01111111000000000000
01110111100000000000
01110011110000000000
01110001111000001100
01110000111100001110
01111111111110001110
01111111111111001110
11111111111111111111
10000000000000001111
11111111111111111111
00000000000000001110
00000000000000001110
00000000000000001110
00000000000000001100