00000000111110000000
00000001000001000000
00000001111111000000
00000001111111000000
00011110111110111100
00110000000000000110
01100000000000000011
11000010000110000001
10000111001111011011
10001111111111101111
11010101111001101111
11110100110111111101
11110100000111000001
10110100000111000010
10010100000001111100
10010100000000010000
10010111111111110000
11110111111111110000
01110011111111100000
01110000000000000000