00000000000000011111
00000000000111110010
00000000111111100011
00000000111000000000
00000000000000000000
00000001100000000000
00000001100000000000
00011111111100000000
00111111111110000000
01111111111111000000
11111111111111100000
01001100111001000000
01001100111001000000
01001100111001000000
01111111111111000000
01001111111001000000
01001100011001000000
01001100011001000000
01111110011111000000
01111100011111000000