00000001111110000000
00000111111111100000
00001111111111110000
00011111111111111000
00111111111111111100
00111111111111111100
01111111111111111110
11101110111011101111
01000100011001000101
00000000011000000000
00000000011000000000
00000000011000000000
00000000011000000000
00000000011000000000
00000000011000000000
00000000011000000000
00000000011000000000
00000011011000000000
00000011011000000000
00000001110000000000