00000000000011110000
00000000000111111000
00000000001111111100
00000000011100011110
00000000011100001110
00000000111000000111
00000000111100000111
00000000111111000011
00110000111111110011
01111000111110111111
11111100000000011111
11001111111111001111
11001111111111011111
11111100000001011111
01111000111101011111
00110000111100011111
00000000111110011111
00000000001111111111
00000000000011111111
00000000000000111111