00001100000000000000
00011100100000000000
00110101101000000000
01111111111000000000
11010011111111100000
11110110000000111000
00111110001110010100
01011110000011000010
11111011000000000011
00110001110000000001
01110000111000000001
00010000011100000110
00010010001111111100
00010010000110100000
00001011000100100000
00001001000111000000
00001000000100000000
00001100000100000000
00000110011000000000
00000011110000000000