00000111111100000010
00001110011110000010
10111000001110010010
01110110111111100010
10001100101011010010
00001010001000000010
00010000001000000010
00010010010000000010
00001000110000000010
00000111100000000010
00011010011100000010
00110010001111110100
01100010000011101010
01010010001100000110
01011111110000000010
00111111110000000010
00001111110000000111
00001101110000001101
00001101110000011010
00011100111000110101