11000111111111111111
10000111111110000111
00110000111000000011
01100100011111110011
11101110011110011111
11101111011111001111
11001111111100001011
11011111111110000011
11011111111110000011
10011111111110000111
10111111111111100011
10111111111111000011
00000000000110010011
11111111111100010011
11111111111000010011
11110001100100001011
11100000011110001011
11000000111111011001
10001100011111011000
00011110000110111100