00000000111000000000
00000000111100000000
00000000110100000000
00000000110110000000
00000000110111000000
00000000110111000000
00000000110111100000
00000000110111110000
00000000110111110000
00000000110111111000
00000000110111111100
00000000110111111100
00000000110111111110
00000000111111111111
00000000110000000000
11111111111111111111
11111111111111111111
01111111111111111110
00111111111111111100
00011111111111111000