00000000111100000000
00000001100110000000
00001111000011110000
00011111111111111000
00010011000001101000
00110011000001101100
00100000000000000100
00100111100011110111
00101111100111110110
01111111111111111110
11111100000000111111
11001111111111110011
10010111111111100101
10110111111111101101
11001111111111110011
00110000000000011100
11001111111111100011
11111111111111111111
00111000000000011100
00111000000000011100