11110111110011111111
11110111110010011111
11100011100110011111
11000001100100111111
11100011001100110011
11110111001001100011
00110110010001000111
00011110000010001111
10001100100010001001
10001100011000010001
11000111001100110011
11000011100110000111
11000010110010001111
11100001011000011111
11100001001100110001
11110001000000111011
11011000000001100100
10001100000011100000
00000110000111110001
00000001111111111011