01110000000000111000
00111011111101110000
00011111111111100000
00011111111111000000
00010001110001100000
00110101110101110000
00110001010001111000
01111110001111111000
01111110001111111100
01010011011001101100
11110001110001111110
11100000100000111010
11100000000000011110
10100000000000011110
11100000000000010100
01110000000000011100
00111010000101111000
00011110001101111111
11111111111111110000
00000100001011000000