00111100011100111110
00011110011100111100
10001110000000111000
11000000111110000001
11100011111111100011
11110111111111110111
11100111111111110011
00101100011000111011
00001101011010111000
11101111111111111011
11101111100111111011
10001101111111011001
00100110000000110000
01110111000011110110
11110011111111100111
11100000111110000011
11001110000000111001
10011110011100111100
00111100011100011110
01111100111110001111