00010000011111100000
01000000111111110000
00010001111111111000
00000000011100111000
00001110101001011100
00011111111111111100
00001111111100111110
00000000000011111110
00000010001111111110
00000001111111111110
00000000111111011110
00000001111111101110
00000011011111110111
01100010011111100111
11110000111111000011
00111001111110000000
00011111111100000000
00011111110000000000
00111000000000000000
11110000000000000000