11010100000000111000
01101000010001111100
11110001110011111110
01101011111001010100
11110110111101111100
01000111111100000000
01000111111011110001
01000001111111111001
01000000111111111011
01000000111111111110
11111100111111110100
00000000111111101100
11110000101011011100
00000001001001011000
11000001001001100110
00000001010000110010
00000010000000010010
00000110000000010010
00000000000000100100
00000000000001100000