00000000000000011111
00000000000000010011
00000001110000101001
00000001011000010011
00000001001111001010
01111101000101111110
11111101000011111111
11011001000000001111
11111110000000111111
11111110000001111111
11111100000011111110
11111000010111011100
11110000011110110000
11100000011100110000
11110000001000110000
11111000000000110000
01111111000011110000
00111111000011110000
00111100001100001111
00111000011111111111