00111100000000000000
00011100000111100000
00011110001111111000
00000111001111111100
00000010100111111110
00111101010011111111
01111110101001110111
11111111010101101011
11101011001011110001
11010111100111101011
11101011111111111111
11010111111111111111
11111110111010111111
11111001110100011111
01110010111010101111
01111001110101011110
00111111111110111110
00011111111111111100
00000111111111111000
00000001111111100000