00000111110111000000
00011000001111000111
00100011111111111011
01001111111000011111
01011111111000001111
10110101110000000001
11000111100000010001
10000000000001000011
10000100000000010001
10000100100000000011
10000100110000000110
10000100001100001000
10000100111111110000
10000100010000000000
10000110001100000000
10001111110110000000
01110111111111000000
00000111111101000000
00000111111111100000
00000111111110100000