00001110000001110000
00010001000010001000
00011111000011111000
00010001100110001000
00111111111111111100
00100000111100000100
00100001011010000100
00100001000010000100
00100001111110000100
01000000100100000010
01000001111110000010
01111111100111111110
01111110000000111110
01111110000000111110
01111110000000111110
01000010000001000010
11000011000011000011
11111111000011111111
01000010000001000010
00111100000000111100