00000000111000000000
00100000111111000000
00000001101111100000
00000001111111110000
10100001111001110000
00000011000011110000
00001110000111110000
00100100000111011100
00000000000111110010
00000000000111011001
10000000000011111010
10100010000011101010
10010100000001111101
10010100000000110110
10010100100000011100
10100100010011011110
10110100010111001110
10010010010110011110
01110010110011111100
11100110110001111000