00000111111111100000
00011100000000111000
00110000000000001100
01100011111111000110
01000101000010100010
01111101100110111110
01000101111110100010
01111111111111111110
00000011000011000000
00000110000001100000
00000110000001100000
00001110001111110000
00001010000111010000
00001011000011010000
00011001111110011000
00010000000000001000
00010000000000001000
00010000000000001000
00010111111111101000
00011100000000111000