00110000000000011110
01100000000001111111
11111111111110111111
10000000000011011111
11000000000001101111
01100000000000110111
00110000000000011011
00010001101001001101
00111111010110110110
01101010001100011111
11011111101110101011
11111000111111111111
10001010100001000001
11111010111111111111
10001000100001111111
10000111000001111111
10000000000001111111
10000000000001111111
10000000000001111111
01111111111111111110