00000000000001111000
00000000000000101100
00000001110001000110
00000001010011100010
00000011111111110011
00111111111111110001
01111111111111111001
11111111111111111001
11111111111111111001
11000111111111111001
10000001111111111001
00000001011111110001
00000001010111110011
00000001010011100010
00000001010011100110
00000001010011000100
00000001010100001100
00000001010100011000
00000001010011110000
00000001010000000000