00000000111111111000
00000001100000001100
00000010001111100110
00111100110000110011
01100111100000011001
11001111000000001101
10011111000000000101
10111111000000000101
10111111000000000101
10111111001111100101
11111110011111110101
11111110111000011001
01111100110000011001
01111001110011100011
01000001110110000110
11000001110100001100
10000001110100111000
10000011110011011000
00001100111000110000
11110000011111100000