00000000000000000000
00000011111110000000
00001111011111000000
00011011111011100000
00111111011111110000
00111101111011111000
00110111011111101100
00011111110110111100
00000011111111111000
00000000100100000000
00000000100100000000
00000001100110000000
00000010000001000000
00000001111110000000
00000000100100000000
00001000100100110000
00101101101101100100
00100111001011101000
00111111111111111100
00000000000000000000