00001111111011111000
00111000011110001100
01100000001100000100
01000011011001001110
01000001111010111011
01001111111111100001
01100011111111000001
00110111111111000001
00011111111101110011
01110010111110011110
11000101111010000100
10000001001001000010
10000011001100000010
10000010000110000010
11000110000011000110
01111110000111111100
00000001111111110000
00000100111101111010
00000011110101011100
00000000000101000000