01100000000000000110
01011000000000011010
00111111100111111100
00011111111111111000
00111000011000011000
00101111111111110000
00100111100111101000
00100000100000001000
00100000111000001000
00110001000010001000
00110001100110001000
00101000111100011000
00101100000000110000
01110110000001100000
10001011111111100000
11111010000000100000
10001010000000100000
11111110000000110000
10001111000001111100
01111111111111111111