00000000000000000000
00001111111111111000
00011000001000001100
00011100011100011100
00110110110110110110
01100011100011100011
01111111111111111111
01100001000001000011
00100001000001000010
00110001100011000110
00011000100010001100
00001000100010001000
00001100100010011000
00000110110110110000
00000010010100100000
00000011010101100000
00000001101011000000
00000000111110000000
00000000011100000000
00000000000000000000