00111111110010111111
01100000011000010111
11000000001100000111
10000000000111100101
10110110010100110001
10010010100110011001
10110110100010001000
10110110100010001100
10000000100010000100
10000000100010000110
10100010011010000111
11000110001110000101
10011100000000000101
10110101001001000101
10100101101001000101
10010010101111110100
11010010101001010100
01110010101001010100
00000010101001010100
00000011111001111100