00000000000000000000
00000000000000000000
00000100001000010000
00001010010100101000
00001010010100101000
00000100001000010000
00001010010100101000
00001010010100101000
00001010010100101000
00111111111111111110
01111111111111111111
01111111111111111111
01111000111110001111
00110000011100000110
00100000000000000010
00111111111111111110
00100000000000000010
00111111111111111110
00000000000000000000
00000000000000000000