00000011111111001110
00000101010110101010
00001110111011011010
00010111011101101010
00111011101110110110
01011101110111011010
11101110111011101111
11111111111111111111
10000000000000000001
10000000000000000001
10011111000000000001
10010101000000000001
10011111001111110001
10010101001111110001
10010101001111110001
10011111001111010001
10000000001111110001
10000000001111110001
10000000001111110001
11111111111111111111