00000000000000000000
00001110000000000000
00111111000000000100
00011011000000001100
00001111111100111110
00001111111111111110
00000111111111100000
00000111111111110000
00000011111110000011
00000000111000011111
00000001100011111111
00000011111111111111
00011110111110000110
11111001100000011100
11000010000000111000
00000000000111101100
00000000001111101110
00000000001111001110
00000000001000000111
00000000000000000000