00111100000000000000
00001110111110000000
00000111111111100000
00001110011011110000
00011111000011011000
00011011011000011000
00110000011011011100
00111011000011101100
00100011011111000100
00111000011100111000
00101011010001101100
00110011100111110100
00011001011111110110
00011110011111111110
00001101111111111110
00000001111111111110
00000000111111111100
00000000011111111100
00000000000111111000
00000000000000010000