00000011110000111111
00001111110000001111
00011111110000000111
00111111110000000011
01111111110000000001
01111111110000000001
01110000110011110001
01110000110011110001
01111001101001100001
01111111101000000001
01111111101000000001
00111111001100000011
00111110001110000011
00011111110000000111
00011111110000000111
00001110001110001111
00000111001100011111
00000011110000111111
00000011110001111111
00000001111001111111