00000110011100000111
00001111000110111110
00000001111111110010
00001111001101100110
00011100011001011010
00000000000000110011
11011011100000100011
10110111001100000001
01101110111110001000
01011101111111001001
01011101111111001011
00011011111111001010
00111011111111010010
00111011111111011110
00011000011111010101
00000111101110111111
00011111110001111111
11111111111111111001
01110001111111111110
00000000011111000000