00000101101111010000
00001111111110101000
00001111110011110110
00000110011011101100
00000100000111111010
00001101100000111110
00011001110010011011
01110000000110011110
01100110001100001101
00011100010111001110
00000111010000001101
00000011111100100110
00000111100011000111
00001101000000000110
00001011000000001101
00001110000100101111
00011001001001011010
00110001101101110100
11111010010000101000
10101011111111100000