11111100111100000000
11111101010111000000
01111001000110011100
10110101011000110111
01001001010000100110
00000001010000101000
00000001011000111000
00001001101000110000
01001100101000110000
11001110101001110000
11100111101111110000
10110111001111110000
11011100001110110010
11000001011110100100
01100011011001101101
01111110110111001011
00111111111111001110
01101110011100001100
01000100001000101001
01101111011110011110