00000001100000011100
00000010110000100110
00000010110001011111
00000010111000111101
01110010111001011111
11111001011000101010
11111100101000011100
10001110010100000000
01110001010100011000
00001111101100100000
00000011111001001110
00011111111111110000
01101010110111101000
01101010110111111111
00011111111011110000
00000010110101000000
01111100100010100000
00000001000010100000
00111110000001010000
00000000000001010000