00000111100000011110
01111100110000110011
11011000010000100001
10001000010000100001
10001100110000010010
11010100100000011110
01110111100000010010
11001100110000101101
10001110010000100001
10001000011001000001
10011000001001000001
10010100001001111101
10010100001011100110
10010100001111111011
11010000001111111101
01011000011111111101
00111000010111111011
00001100110111111111
00000111100011111110
00000000000001111100