01111000000000000000
11000100000000000000
10100010000000000000
10000010000000000000
10100010001111110000
11000100111010001000
01101101100011010100
00101011110111000110
00101011001100111110
00101111111001010011
00101110011100010101
00110111111111110001
00010011110011111111
00011001111110010001
00001111111111111111
00001110001111111111
00011100011010100110
00111000110011010011
00111001100001111001
00001111000000001111