00001110011111100000
00000100110011000000
00000101100110000000
01100011000101110001
01111011010110011001
00001101010100001011
00000011101000111011
01111101111001001011
11000000011101100111
10000001111110010111
10000111100101010111
01111101001001010011
00001010011100111011
00010010010011111001
00111010011000111101
00000011001000001101
00000001110000000111
00000000000111110010
00000000111111111110
00000011111111000110