00000000111100001110
00000001101100111010
11100001101001110110
10111001011001101110
11011101011001011100
01101101111011110000
00111100110110000000
00000110010100000000
00000011011011111100
00111101110111001110
01101111111111110111
11011001111000111011
10110111111111011101
11100100000001000111
00000111111111000001
00000010000010000000
00000011000110000000
00000001000100000000
00000001000100000000
00000001111100000000