00001100001111111111
00000100111001100101
00110111110000101110
00010110001001110110
11011100011101010000
01011000111110100000
01110000110110000000
00111100010100000000
01100110101010001100
01100010011100010010
11001111101001110010
11011111110010010010
11011111110010010110
10001101100011010100
10111101111001011110
10011010110000111111
10000111000011111111
11000010000010111100
11000000000001001010
11000000000000000100