00011111000011111000
00110001111110001100
00100110000001110110
00100100000000111010
00110000000000011010
00011101000100010110
00001110000000101100
00000101110100111000
00011100100101100000
00110110001111110000
01101111111110011000
11001011111111001100
10011011011101000110
10111000000011000011
11111100000110010001
01001111110000010001
01000010011000011011
01000010000000011110
01111110000000111100
00000011111111111000