00000000000000000000
00011110000000000000
00000111001111000000
00000001111111110000
00001110011111111000
00110111010001111100
01001101101110111100
01011011100111011110
00110011010111111110
00110110110011111100
01100100011000111100
01110100011011011100
01110000101011101000
00111010101101111000
00011110100101111000
00000111000111110000
00000011110101100000
00000000111101100000
00000000000111000000
00000000000010000000