00000000000000000001
00000000000000000011
00000000000000000011
00000000000000011111
00000000000001111111
00000000000111000011
00000000011111110001
00000001111111110001
00000111111111111101
00011111111111111111
01110011111111111111
11000111111111111110
10011111111111111100
11111111111111111000
11111111111111110000
10111111111111100000
11111111111111000000
11111111111100000000
11111111110000000000
01111111000000000000