00000001100001110000
00000001010011010000
01100011011110010000
01011010000000100000
10101011101101101000
11010100111000110000
01110100010010100110
00100110111100101010
01110011000001001001
01011111111111100101
01100010110100110101
00111110000110010101
00100001111110010101
00000011000100011101
11110110111110111011
10011100100111010110
10011000100010111100
11001011110011100000
01101110010110000000
00111000011100000000