00000000001110000000
00011000000111000000
00111000000011100000
01110000111011101111
01110011101111111001
01111010010101101011
01111110110011110110
00111111011010011100
01111100101100010000
11000010000001111000
10001100000001101000
00000000111000101000
11000100110100001100
11111100000000011010
10111100000000110111
11011110000000000101
10111111100010110001
11101101111110010011
11011101110011000110
10011011100001111100