00000000000011100000
00000001110110110000
00000011001100011000
00000110011000001100
00001100110011000110
00011001100110110011
00110011001101100110
01100110001000001100
11001100110110011000
10011001100100110000
11110001000011110000
10011110011110010000
10000011110000010000
10000011110000010000
10000110011000010000
10001100001100010000
10011000000110010000
10110000000011010000
11100000000001110000
11111111111111110000