11111111000011111111
11111111100111111011
10000000101111001010
10100010101111000010
11110111101100000000
10000000101101110111
10100010101100100010
10011110100100000000
11001101101000001100
01110011001000000000
00111110000100011100
00001000000100110010
00011110000110000000
00110011000011100001
00100001000001111111
00100011000111110111
00100001001111001001
00100111011111101011
01111110111111111111
01111111111111111111