00000011100001110000
00000110111001010000
01110111100001000111
00110111110111001111
00011111000110011111
00111111000000110011
11111110000000100001
11111100000111111101
01111111000100011001
00101101100110000000
00100110100010010000
00011001100011100000
00001111110001000000
00000001111000110000
00000011111100011110
00000011101100000011
00000001111111000111
00000000111111111111
00000000011011111011
00000000001111111111