00000011111000000000
01100110011100000000
11110111101110000000
11110010111110000000
11110101011110000001
11100010001101110110
01000001110011111111
11110000111110011100
01000001111001000000
00001101111100100000
00001011101110111110
00100111001101110010
00010000001111110100
11110000010000001000
11110010011110011100
00110001010101110011
01111111001010001111
11111111101010000001
10110110100110000000
00010010001110000000