00000111111000000000
00001111111110110000
00011110000011101000
01011100000011011000
10111000111111011000
10101001100000010000
10101011000100100000
01101110100000100000
00001100001100100000
00000110000000111000
00000011000001101100
00000011111111110110
00000110000111110010
00101100000011000010
01111100001010000110
01011100110111001111
10000100111101111001
10000010011010000001
10000111011011100011
01111100111111111110