11110000111111111110
11100011111111111111
11000111111111111111
11001111111111111111
10011111111011111111
10111111110001111111
10111110000001111111
00000101110101111111
00000101101101111111
00000101111001111111
00001000000001111111
00010000000011111111
00011100000111111111
10000100000111111111
10000111101111111111
10000111011111111100
11000100000000000100
11000111111110000100
11100000000100000100
11110000000100000100