00011100001100000011
00001110001100000111
00000011001100011110
00000001100100110000
00000000100101100000
00111110110111000000
01111111011101111000
11111111101011111110
11111111110111111111
11111011011101111111
11100111101110111111
11011111011111011111
10111111011111011111
01111110111111101111
01111101111111100111
11111101111111100111
11111000111111100011
11110000011111000011
11100000011110000001
11000000001100000000