00000111111111000000
11110100000001011110
10010100011001010010
11110100011001011110
11110100000001011110
11110111111111011110
10010000011000010010
11111111111111111111
11111111111111111111
01000011111111000110
01000011111110111010
01011010000010111010
01111110000010111010
01000010000010111010
01011010000010111010
01111110000010111010
01000010000010111010
01011010000010111010
01111110000011111110
01000010000010000010