00000000000000001100
00000000000100001100
00000100000110011111
00000110001111000111
00001111111111110100
00001111111111111000
00001111011101111100
00011111001100110010
00011111110011100010
00011111111111100111
00010011110011111111
00010001111111111111
11011001111111010101
11101111111111101011
11110111010101101011
01111111101011100010
00111111101011111110
00011111100011111100
00001111111111111000
00000011111111100000