10000001111111110000
11000011111111111000
01110011100000011100
00010011000000001110
00010011100000011110
00010001111111111110
00011001111111111100
00001111110011111100
00000000111100111100
01111001101110111110
11111111111110111110
11111111011110111110
11111111111110001111
11111111111111101111
11111111111111100111
01111111111111110111
01111111111111111111
00111111111111111111
00011111111001111110
00000111100001111110