00000001111111000000
00000111000001110000
00001000000000011000
01110111000000001100
01010101000000000110
10000000100100000010
10100010100100000010
10001000100100000011
11001001100010000001
01111111000111100101
10101010001000001101
11101011111111111001
11111111111111110001
11111111111111000011
00011110000100000010
00111100011010000110
01011000100100001100
00110001101000111000
00000001010111100000
00000001111100000000