00000111000111110000
00011111101111111100
00111101111011011110
01111000110001001111
01110001111110000101
11010011111111110001
10000111101011111000
10000110101000111100
00001110010000010110
00001110000000000010
00011100000000000010
00011100000000000000
00011100000000111110
00111100000011100011
00111000011110000000
00111000100000000000
01111011111111111111
01111000001111111111
01111000000001111111
11111111000000011111