00000000111110100000
00000001100011000000
00000010011100000000
00001111110011101000
00011111011111110000
00010011101100000000
00101001010111100000
00110011101110011000
00011111010111100100
00001110101011010110
00000011110011101010
00000100110010101010
00000000010110101010
00000000001110110110
00000000111100110110
00000001111001101100
00000001111011011000
00000001111011010000
00000000101101001000
00000000000110100000