11100000111100000001
01010001111110001111
01001101000011010001
01010110111100101010
00100101010011000100
00010111110101111100
00101101011010101000
01101011011111110110
11010101100100101011
11010011011011111011
11011111011011001011
11010100100110101011
01101111111011010110
00010101011010110100
00111110101111101000
00100011001010100100
01010100111101101010
10001011000010110010
11110001111110001010
10000000111100000111