00000001111110000000
00000111111111100000
00001111111111110000
00011111111111111000
00111111111111111100
01111111111111111110
01111001111110011110
10110110111101101101
11001111000011110011
11101111011011110111
11110110111101101111
11111001111110011111
11111111111111111111
01110111111111110110
01111011111111101110
00111100000000011100
00011110000001111000
00001111111111110000
00000111111111100000
00000001111110000000