00000000000000000000
00000000001000000000
00000000011100000000
00000000111100000000
00000001111100000000
00000001111100000000
00000011111100000000
00000011111100000000
00000111111010000000
00000111111101111000
01001111111111111110
01111111011111111111
00000000001111111110
00000000011111111100
00000000011111100000
00000000011110000000
00000000011000000000
00000000010000000000
00000000010000000000
00000000011000000000