00000001111110000000
00000111111111100000
00001111000111110000
00001100000011111000
00011001111111111000
00011111111111111100
00011111111111111100
00011111111111111100
00000111111111111000
00000100011111100000
00001100011001100000
00001100001011110000
00011000100011110010
01011000100101110100
01011000110111110100
11001110011111101101
11010111111101111001
10011001011101011110
01111110000110001100
11100001111111110011