00001111111111110000
00000011111111000000
11100001111110000111
11111001111110011111
11111001111110011111
11111000111100011111
11111100000000111111
11111000000000011111
11110001111110001111
11100011111111000111
11100111111111100111
11000111111111100011
11001111111111110011
11001111111111110011
11000111111111100011
11100111111111100111
11100011111111000111
11110000111100001111
11111000000000011111
11111110000001111111