00000011111110000000
00001110001111110000
00011000111111111000
00110000111111111100
00100001111100011110
01100001111100011110
01000000111100011110
11000000111111111111
10000000011111111111
10000000011111111111
10000000001111111111
10000000000111111111
11000000000111111111
01000011100011111110
01100011100001111110
00100011100001111110
00110000000011111100
00011100000011111000
00000111000111100000
00000001111110000000