00000000000000000000
00000000000000000000
00000000000010000000
00000000000010000000
00000000000110000000
00000000001111000000
00000000011011111000
00000000010000010000
00000000110000100000
00000000100001100000
00000000100001000000
00000000100001000000
00000000101010000000
00000000111010000000
00001000011110001100
00000111101001111000
00000011111111111000
00111100000000000000
00000011100011111110
00000000000000000000