00001111111111110011
00001000111111100011
00011111111111001011
00110111111110011011
11011011111100111011
11101111111001110101
10111111110011101110
10111010100111100000
10111010001111100000
10111010011111100000
11111000111111100000
11111000111111110001
11110010111111111111
11100000111111000000
11001101111110011111
10001101111111000000
00011101111110011111
00111101111111000000
11111101111110011111
00000000000001000000