00001111111111000000
00111111111111110000
01111111111111111100
01111111111111111110
01110111111111111110
00111000111111111110
00111111000111111110
01111111111000001100
01011101111111111000
01001100111001111110
01001001010011111111
01100000000010101111
00111000000010010000
11110000001100010000
11110000100000111000
11110100011100111100
01110110000001111100
11110011000011111000
11100001111101110000
11100000000011111100