00000001000000000000
00010010100100000000
00101111111010111100
00111111111110111000
00111111111110111100
00010000000100100000
00010110110100100000
00010110110101010000
00010000000110101000
00010101010100100100
00010101011010101010
00010101010101010101
00010000011111111111
00010001001000000010
00010010101011011010
00010010101011011010
00010010101000000010
10111010101010101010
11111111111111111111
01010101011101010111