00000000000000000000
00000000000000000000
00000000000000000000
00000110011110011100
00001111111111111100
00011001111001110100
00111111111111110100
00100000000001111100
00101100001101111100
00101100001101111100
00100000000001111100
00101100001101111100
00101100001101111100
00100000000001011100
00101100001101011000
00101100001101110000
00100000000001100000
00111111111111000000
00000000000000000000
00000000000000000000