00000000000000001111
00000001111100001111
00000110000110011000
00001100110011010000
00011011000001111100
00110110000110000010
00100101111000000001
01101011100010010001
01001011001110010001
11000010011100110001
10100100100011100001
10111100001110000011
11011100000000000110
11100111000000001110
11110101111000111100
01011110000011111100
01111111111111111000
00110011111111110000
00011111111111000000
00001111111000000000