00000000001100010111
00000011010100000111
11101111100100010011
10011110011110000000
11011011000011100101
01110000000000100000
00010000010101101100
00110010000111001010
00100000110110001011
00110010110110001001
00011111001110010001
00000101111010011011
00001100000111011111
00001110101111111111
00111111010110111110
01101111101111011000
10001111111111000100
10011001111001100100
11110010110100111100
00011111001111100000