00000000000000000000
00000000000000000000
00000000000000000000
00000000000000000000
00000000110111101000
00000001001111110100
00000001001111110100
00000001001011010100
00000111101111111000
00001111110111110000
00001111110111100000
00011111111011100000
00101111111101101000
00001111111101111000
00000110001100110000
00000110001100000000
00000000000000000000
00000000000000000000
00000000000000000000
00000000000000000000