00000000001110000000
00001100011000000000
00000111111000000000
00000000111111000000
00000011111001100000
00000010111000000000
00000000001110000000
00000000011111000000
11000000111111000000
01110011101111000000
00011110001111000000
00000111111111000000
00000001111110000000
00000011111110000000
00000011111111000000
00000011111011111100
00000011111000111111
00000001111100111111
00000111001100011111
00000000001000000110