00000000011000000000
00000001111110000000
00000011000011000000
00000110110001100000
00001101100000110000
00001011000000010000
00001010000000010000
00001010000000010000
00001000000000010000
00010000000000001000
00010000000000001000
00011111111111111000
00010010000001001000
00111111111111111100
01100000000000000110
11000000000000000011
11111111111111111111
00000001110010000000
00000000111100000000
00000000011000000000