00000000000000000100
00000000001000001110
00100000011100001110
01110000011100000100
01110000001000001110
00100000011100001110
01110000011100001110
01110000011100001110
01110000011100011111
11111000011100000100
00100000011100000100
00100001111111000100
00110000001000001100
00011000001000011000
00001111111111110000
00000000111110000000
00000000001000000000
00000000011100000000
00000001111111000000
00000011111111100000