00000000100100000000
00000000100100000000
00000000110110000000
00000000110110000000
00000000110111000000
00000001111110100000
00000111111110100000
01111110011100010000
01111111111001010000
00011111111001001000
00000010111000101000
00000010111010100100
00000101110010010100
00000101110001010010
00011001110001010010
01111001010011010011
11011001110011110111
11101001010011111001
10111001110011110001
10011001110011010001