00001111111111111100
00001111111111111100
00111111111111111100
00101111111111111100
00101111111111111100
00100000000000000000
00100000000000000000
00111111111100000000
00000000000100000000
00000000000100000000
00000000000100000000
00000000000100000000
00000000000100000000
00000000001110000000
00000000001110000000
00000000001110000000
00000000001110000000
00000000001110000000
00000000001110000000
00000000001110000000