00000111111111000000
00001111111111111000
00011100011111110000
00011100101111111110
00011111000111111100
00011110010111111111
00011111000111111100
00001111110000110000
00000111110001111000
00001111111011111100
00111111111111111110
01111101111111101111
11110000111111000111
11100001111111001111
11110011000101011110
01111110000001111100
00011011111111011000
00001011111111010000
00000111111111110000
00000111110111111000