00000000000000000001
00000000000000000001
00000000000000000011
00000000000011100010
00000111100110110110
00011111110100011100
00111101111100000000
01111000111111110000
01111101101111111000
11111111111011011100
11111110011110101100
11111110010011011100
11111111110011111100
11111011111111111100
01100000111111111100
00000000001111111100
00000000000111111000
00000000000111111000
00000000000011110000
00000000000011100000