00001000000000100000
00001100000000100000
00001100000001100000
00001010000011100000
00000101101111000000
00000110011111000000
00000001111100000000
00000011111111000000
00000110001111100000
00001100000111110000
00001000000011110000
00001111111110010000
00011001111111011100
00110011101111000100
00100010001001000110
01000110011001100010
01111111000011111110
00111111011011111100
00001111100111110000
00000000111100000000