00000000111001100000
00000001111101100000
00000111000111100000
00001100000001100000
00011000000000110000
00010101010101011000
01111111111111111100
00010000000000010000
00010001111100010000
00010001010100010000
01110001111100011110
11010001010100010011
00010001010100010000
00010000111000010000
00010000000000010000
00010000000000010000
00111111111111111000
00000010000100000000
00001010000101000000
00011110000111100000