00000001111000000000
00000011111111000000
00000011111001110000
11000010110000011000
11100000100000111000
11110011101001111000
01110011001101111000
10111010000001101000
11011011000001001000
01101101111000011100
00110110011111110100
00111110010000000110
01101110110010000010
11000000101010000010
10000000101010110011
10000000101010100001
11000000101010100001
11100001111011111001
11111001010010000001
11111001111111111111