00001111001111111000
00011100111000011100
00110001100111101110
01100101011111110111
01101110111111111011
11101111111111111011
11001011111111011101
11001001111110011101
10001100111100111110
10101111100111111110
00101111000011111101
01111110000001111101
01111000011000001101
01111000000000001111
10111001111100001110
10111101000010011110
11010100111100011111
01101110000000111100
00111101000011011001
00011100111100100011