00000001110000000000
00000011111000000000
00000001110000000000
00000000100000000000
00000001110000010010
00000010110000011110
00000010110000110011
00000010111011000001
00000010011110000011
00000010001100011001
01111110001000101001
11000011111000101011
10000001111100100110
00000000011100100000
00000000001100100000
00000000001100100000
00000000001100100000
00000000001100100000
00001000011110100000
00110111100100100000