00000000000000000000
00000000000000000000
00000100110000000000
00001110010000001000
00011101111110111000
00111111110011100000
00010111100110110000
00001111000110011000
00101101111000011010
00111000111011001110
00010110111011001100
00010110001100001100
00011000110110011000
00111000110011011000
00101100000001110000
00100111100111110000
00000001111111000000
00000011100000000000
00000010000000000000
00000000000000000000