00000000000000000000
00000000000000000000
00000110000000000000
00001111000000000000
00001001100000000000
00010111111000000000
00011111111111000000
00011001111110111000
00110110110011001111
01110101101101110011
01100011111011111010
00100011100111110100
00110001000011101100
00011000100001111000
00011110000111100000
00000111001111000000
00000010000011100000
00000110000001110000
00000000000000000000
00000000000000000000