00001001111110001000
00001011000111001000
00001010101011001000
00001010000001001100
00111001011010001010
01101000100100011010
01001111000111101100
00111001000000011000
00001111010011101000
00001001000010001000
00001001111110001000
00001110000001111111
00011110001101111110
00111101010011111100
01111001100111111000
11111011101111110000
00001010101000000000
00011001101000000000
00100010001000000000
00011101111000000000