00000000000000000000
11101111011111111111
11010000101111111111
11000000001111111111
11000000000111111111
10010010000111111101
10000000000001111101
10001100000000011101
10101001000000000001
10011110000000000001
10000000000000000001
10000000000000000001
10000000000000000001
10000000000000000001
10000000000000000011
11000000000000000011
11001100111100110011
11001100111100110011
11011101111101110111
11111111111111111111