11000000011110110000
10110000010101111100
10011110010101101110
10000010010111001011
10000110011111011011
10000010010001111110
10111110011100001101
11010100100011110001
00010101001000111111
00010101100000111110
00010100110000111111
00010100100000111011
00010100110001110111
00011100001110011101
00100010011000001011
00100011010000000111
00100010110001000111
00011110010001000110
00010111010011000111
00010101110011000110