00000000000000000000
00000000000000000000
00000000000000000000
00111101011011111100
00110110110111111100
00111010101111111100
00110000011111111100
00101101100111111100
00111000111111111100
00110000000000000100
00100000000000001100
00100100000000001100
00111110000000001100
00111110101110100100
00111110101110110100
00111101101110110100
00111101101110110100
00111001001100100100
00000000000000000000
00000000000000000000