11001111111111110011
10011000000100011001
00100000000000000100
10111111111111111101
10001110001111100001
01011011111111110010
00110111100000011000
01101111010101001100
01001110000000000100
11011101000100010110
10011000000100000010
10011000000100000010
10011010001111101010
10011000000100000010
10011000000000000010
11001101000000001010
01001110000000000100
01100111010010101100
00110011100000011000
00011101111111110000