00001111111111110000
00111111111111111100
01111101111110111110
01111011100111011110
01111011011011011110
00000110100101100000
00001110110101110000
00111111011011111111
11101111100111110000
00001111111111111110
00001100111000000001
00111000010001101100
11100001101000000000
10001110000100111110
11011000010110000000
01100011100011001111
00110110011111111111
00110001111101110000
00011011110000000000
00001110000000000000