00000000000000000000
00000000000000000000
00000000000000000000
00000000000000000000
00111111110000000000
00011111100000000000
00011001100000000000
00011011100111100000
00111111100011000000
00111111111111110000
00111111111111111000
00111111111111111000
00111111111111111000
00111011111101111000
00010001011000111100
00011011001101100000
00001110000111000000
00000000000000000000
00000000000000000000
00000000000000000000