11100000000001100000
10110000000011100000
10011000001110100000
10001100111100100000
11000111111111101110
11000000001111011111
10000000001011011111
10000000000001010011
10100000000001000011
11010001000011000011
10100010100010000111
10011101000011111110
10001000000111111100
11011111100111111000
01100000001100111000
00111111111000010000
00110000000000010000
00110110001100110000
00111111111111110000
00011001110011100000