00000000000000000000
00000000000000000000
00000000000000000000
00000000111110000000
00000011111111000000
00000111111111110000
00001111111010110000
00001111011110011000
00011110000110000110
00011010000011111110
00011000001110000000
00111001111000000000
00110001000000000000
00110011000000000000
00110011000000000000
00100010000000000000
01100010000000000000
01000110000000000000
00000000000000000000
00000000000000000000