00000000000000000000
00000000000000000000
00000000000000000000
00000011111000000000
00001111100000000000
00011111110111000000
00110111101110000000
00111111111000000000
00011111111100000000
00001111101110000000
00000011110000000000
00000000000001100000
00000000111011111000
00000000011111111100
00000000000111110110
00000000001111111100
00000000011001110000
00000000000011000000
00000000000000000000
00000000000000000000