00000000000000000000
00000000000000000000
00110000000000001100
01111000000000011110
01001100000000110010
01000101111110100010
01000111111111100010
01001111111111110010
01111111111111111110
01110000111100001110
01100011011011000110
01100011011011000110
01100000011000000110
01110000111100001110
00111111100111111100
00011111111111111000
00001111111111110000
00000111000011100000
00000001111110000000
00000000000000000000