00000000000000000000
00000000000000000000
00011111000000000000
00001111100000000000
00010111100000000000
00111111100000011100
00111011101110111110
00000011110111111110
00000111110011001110
00001111111111000111
00001111111111100000
01000111100011100010
01000110000001110110
01101100000000110110
01111000000000011100
00111110000001111100
00011111111111111000
00000111111111100000
00000000000000000000
00000000000000000000