01111100000000110011
00111100111110011111
11110011001111101100
11100110001111100111
00101100111111110111
11101001111111110111
11101011111111110100
10101111111111110110
00100111100111101111
01110011011011001111
11111001100110011001
11011101100110111111
10011101100110111111
00111101100110111111
01110110000001100111
11110111000011111011
11100110000001111011
11101111000011111111
11111110000001111111
11111111000011111111