00000001111111000000
00101001100101110000
00010101011001011100
00011101110110101110
00101000101100110110
11111000110001001101
00011000111110101100
00001000110100000001
00001000111101010110
00001110010110001001
00001111011101000010
00001111111111110101
00001111111101000101
00000111111111010010
00000111111111110011
00000011111001111101
00000001010000011111
00000001010000000111
00000001010000000000
00000010101000000000