00000011001111000000
00000111101011100000
00001101111111100000
00001110110111111000
00011111011100011100
00110011001011111110
01101111000111111111
11011111001111111111
01111010110111111111
01110101111011111110
00001011110100111100
00001111100100000000
00001111100101111110
00001111000110111100
00000110000101111000
00000000000111110000
00000000000110000000
00000000001000000000
00000000001000000000
00000000001000000000