11010111100000000000
10101011110000000000
11010111111000000000
11101111001000111111
01111100101100100001
00111000000100111111
00011101001000011110
00011100111000001100
00001100001000011100
00000101110000110010
00001100100000100010
00010000011000100110
00111000001100101100
01111100011100101000
01111110111110101000
11111111111110101000
11101110111111101000
11101111110111001000
11101110110111001000
11011111111011110000