00000000000000000000
00011110000001111000
00101011011011010100
01001001100110010010
11001111100111110011
11111001100110011111
10000110100101100001
10000000100100000001
10011100100100111001
10101100100100110101
10100000100100000101
10100011000011000101
10100100111100100101
10110101000010101101
11100100111100100111
01101001011010010110
00101010111101010100
00011101000010111000
00001010111101010000
00000110011001100000