00000000000000000000
00000000000000000000
00000000000000000000
00000000110000000000
00000001111000000000
00000001111000000000
00000000110000000000
00000001000110000000
00001001000011000000
00011011000011000000
01111011000011000000
00111111111111000000
00011111111111100100
00011111111111100010
00001111111111100010
00000111111111111100
00000001111000000000
00000000000000000000
00000000000000000000
00000000000000000000