00000000000111100000
00000001101111110000
00000000111011111100
00000001001101000110
00111001110110000010
00111110110000110010
00011000000001110010
01101100001010000110
10110110110001001100
11110011100111111000
01100000111111000000
00111101111111100000
01000111100111110000
01101000001111110000
00110111111111110010
00100011111111110001
00100001000010100001
00000000100010110011
00000011111110011110
11110111111110000000