11111000001111011101
11100000000011111110
11000000000001111111
10000000111101110111
10000001111111111111
00000001111111111110
00011011110111111111
00001001111111101011
00000000111111110111
00000001111111101011
00000011111011111111
10000001111111011111
10000000111101111111
11000000000001111111
11100000000011111011
11111000001111110101
11101111111111111011
11010111111110111111
11101111011111111110
01111111111111111100