00000000000000000000
00000000000000000000
00000011001001100000
00001011001001101000
00010000001000000100
00101111001001111010
01011111101011111101
00111111101011111110
01111111001001111111
01111111001001111111
01111111001001111111
01111110001000111111
00111100001000001111
00111100001000011110
00111110001000111110
00011111001001111100
00011111001001111100
00001111001001111000
00000110001000110000
00000000000000000000