00000000001100000000
00000000011110000000
00000000011110000000
00000000011100000000
00011111100000000000
00111111110000000000
01100011110000000000
11000111110000000000
11101111110000000000
00111111011000000000
00011110011000000000
00011111011000000000
00011111111000000000
00011011011100000000
00011011100110000000
00011001110011100001
00011000111000111011
00111000011000001111
00110000011000011111
01100000011000111111