11011100011111110000
11011100010100110000
10110100110000111000
10110100100000011000
01110101100001011100
01101001000000111100
11101001111111111100
11011010011111110010
11010000101000101000
10110100001101100000
11100110000111000001
01000010000111000011
11000110001101100011
10000100011000110110
00001000010000111100
11111110010001100110
10100010001001001101
01100010001001000001
00110110011111100011
00011100111111111110