00000000000000000111
00000000000000000101
00000000000011111111
00000000001111111100
00000000011111111110
00000001111111111110
00000111111111111110
01111100011111111110
10011111100111111110
11000111111011111110
01000001111101111110
01100000011110111100
00100000001111011100
00110000000111101000
00011000000011101000
00001100011101110000
00000110011100110000
00000011011100110000
00000001110000010000
00000000011111100000