11110011111111011100
11100001111110110111
11100001111110111100
11110011111110111000
11111111111101111100
11111111110011111100
00000000001111101110
00000000111111001110
00000001111100110110
00000111000011001110
00011100111100101100
11110011000011101000
00001110111111010000
00000000000110100000
00000000000011000000
11000000000001000000
11110001111101011110
00011111110001000111
00000000000001110000
00000000000001100000