00000000000000000000
00000000000000000000
00111100000000111100
00111000000000011100
00100000000000001100
00100000000000000100
00000000000000000100
00001100001110000000
00011110011111000000
00011110011111000000
00001100001110000000
00000001100000000100
00100000100000001100
00110000000000011100
00110101010100111100
00111111111100111100
00111010101001111100
00111000000001111100
00000000000000000000
00000000000000000000