00000000000000000000
00000000000000000000
00000000000000000000
00000000000000000000
00000111000000000000
00011101100000000000
00011111100000000000
00000011000000000000
00000111000000000000
00001110000000000000
00001100000000000000
00011100000000000000
00011000111100000000
00110001111110000100
00110011100111000100
00111111000011101100
00011110000001111000
00000000000000000000
00000000000000000000
00000000000000000000