00000000000000000000
00000000000000000000
00000000000000110000
00000000000001101000
00000000001110110000
00000000011111001000
00000000111111111100
00000001111111111100
00000001111101111000
00000011111110100000
00000011110111000100
00000001110001111000
00001111100000010100
00011000000000010000
00110000000000000000
00110000000000000000
00110000000000000000
00111000000000000000
00000000000000000000
00000000000000000000