00000000000000000000
00000000000000000000
00000000000000000000
00000000111111001000
00000011100001110000
00001110000000000000
00011000010000111000
00110000011101111100
00100000111110111100
00100000111111011100
00100000111111011100
00100111011111101000
00101111101111110000
00111111100111011000
00111111111110011100
00111111111111111000
00001111100111100000
00000111111000000000
00000000000000000000
00000000000000000000