00000000000111111110
00000000011111110011
00000001111111101111
00000111111100111111
00011111100000111111
00111110000000001110
01111100000000000000
11111010000000100000
10011011000001100000
01111011111111100000
11110111111111110000
01101111000001111000
00011110101010111100
00011101000001011100
00111101011100011110
00111100000001011110
00101101000001011110
00101110101010111110
00110111000001111110
00111111111111111110