00000000000111000000
00000011111110000000
00111111111110000000
11110111111111100000
01111111111111110000
00110011111111111000
00000111111111111100
00111111111111111100
00000011011101111110
00000110001100111110
00000000001100111111
00000000000100111011
00000000000000111001
00000000000001111000
00000000000111110000
00000000111111100000
00000011111111000000
00000111111110000000
00011111100111000000
01111110000011100000