00000000011110000000
00000001110011110000
00000111001010011000
00001100110101101100
00001100010110000110
00000111000001110010
00111101111011011010
01111100001110001110
01100101000000101100
01100101101101101000
01100101101101101000
01110101101101101000
00111101101101101000
00011101101101101000
00000101101101101000
00000101101101101000
00000101101101101000
00000110101101011000
00000011000000110000
00000001111111100000