00000000111100000000
00000001111110000000
00000011011011000000
00011011111111011000
00111011111111011100
01111101100110111110
11101110111101110111
11101111000011110111
11100111111111100111
11110011111111001111
11110011111111001111
01100111111111100110
00001111111111110000
00011111100111111000
00111111000011111100
00011111100111111000
00001111100111110000
00001111100111110000
01111111000011111110
11111110000001111111