00000011111111100000
00000111111111110000
00001111111111111000
00001111111111111000
00011111111111111100
00011111001111001100
00011110000110000100
00011110010110010100
01101110110110110100
01111111111111111110
01111111111100111110
00111111111011011110
00011111111111111110
00000111111111111110
00000111110000011100
00000011111111111100
00000011111111111000
00000101111110000000
00001111010101100000
00111111111111111000