00001111111110000000
00001000000011000000
00001000000011100000
00001000000011110000
00001000000000010000
00111000000000011100
00111000000000011100
00111000000000011100
01111111111111111110
11111111111111111111
11000000000000000011
10001111111111110001
10001111111111110001
10001011111111010001
10001000000000010001
11111011111111011111
11111000000000011111
11111011111111011111
11111000000000011111
11111111111111111111