00000000000000000000
00000000000000000000
00000001011110000000
00000110111111100000
00001110111111110000
00011110111111111000
00010110011111111000
00110110011111111100
00110111001111111100
00110111000111111000
00110011100000000100
00111001111000011100
00111000111111111100
00011100001111110100
00011110000000001000
00001111100000110000
00000111111111100000
00000001111110000000
00000000000000000000
00000000000000000000