00000000000000000000
00000000000000000000
00000000000000000000
00000000000011000000
00000000000100100000
00000000000101111000
00000001111011111100
00000111111111101110
00001111111111111110
00011111111111111100
00011111111111100000
00111111111111000000
01111111100111000000
01011111111011100000
01100111111100000000
00110000000000000000
00011111000000000000
00000000100000000000
00000000000000000000
00000000000000000000