00000000000000000000
00000000000000000000
00000000000000000000
00001111111100000000
00010111111110000000
00010011111111100000
00100010010000010000
01111010010000010000
01111111010000010000
01111111111111111000
01111111111111111110
01111111110011110010
00110111111111111110
00110011111111111110
00000011111111111110
00000001110000011100
00000001100000011000
00000000000000000000
00000000000000000000
00000000000000000000