00000000011000000000
00000000111111110000
00000000111111111000
00000000011110111100
00000000001111111110
00000000000111111110
00000000000111111111
00000000000011111111
00000000000011111111
00000000011111111111
01000000001111111111
01000000000111111111
11000010000011111111
11000110000011111111
11101110000111111110
11111110001111111100
11111100111111111100
01111111111111110000
00011111111111000000
00000111111100000000