00000000000000000000
00000000000000000000
00000000000000000000
00000011111111100000
00000110000000110000
00001100000000011000
00001001100011001000
00001011000110001000
00001111111111111000
00001000001000001000
00110110001000110110
01000011001001100001
01011011001001101101
01011011101011101101
01100011101011100011
00111111111111111110
00011000000000001100
00011000000000001100
00000000000000000000
00000000000000000000