00001110000000000000
00011111000000000000
00111111100000000000
01111111110000000000
11111111111000000000
00011111000000000000
00001110000000000000
00011110000000000000
00011111000000000000
00101110100000000000
00101110100000000000
00011010100000000000
00000101100000000000
00000101100011000000
00000101011100100000
00000100111111100111
00000011111110111011
00000000000001111100
00000000000001001000
00000000000000110000