00000011111111100000
00000110111011111000
00001100001110111110
00011000000011101111
00110011110000111111
01100111111000100000
01001111011100101111
01011101110110101111
01011010100010101111
01011110100010101111
01011111100010101111
01011111100010101111
01011111110110101111
01001111111100101111
01000111111001100000
01000001110011011111
01110000000110111111
00011100001101111110
00000111011011111100
00000001111111111000