00000000000000000000
00000000011000001000
00000000001100011000
00000000001110110000
00000000001111110000
00000000001111111000
00000000001110101000
00000000001111111000
00011110000111110000
00111111000111110000
01111111100011111100
01001111100111111110
00001111100111111110
00001111101111111010
00001111101111111000
00001111111111111000
00000111111111111000
00000000000110011110
00000000000111101110
00000000000011100000