00000000000000000000
00000000000001110000
00000000001111111000
00000000011111111000
00000001011111111100
00000111011111111100
00001111101111101100
00011111101111111100
00011111110111111100
00111111111001111100
00111111111111111100
00111111111111011101
00111111111111011111
00101111111111001110
00101111101111000000
01001111001110000000
00000111001110000000
00000111001100000000
00000011001100000000
00000000000000000000