00000000000000111000
00000000111001111000
00111001111101110000
01110101111101100000
01100001101111100000
01100000001110110011
01100000011000011111
01110000010000110011
00111110010000100001
00010011011000000001
00100001101000010011
00100000111100001110
01100010001111100100
01010010100110011000
11110010101100000000
10100111101000000000
10101101101100000000
10101111100111000000
11100010110001000000
01111110011111111101