00000111111111100000
00001011000000010000
00001011000000010000
00001011000000010000
00111111111111111100
01000000000000000010
10111111111111111101
01111000000000011110
00001000000000010000
00000100000000100000
00000101000010100000
00001100000000110000
00010100011000101000
00111011000011011100
00011101000010111000
00011110111101111000
00111111000011111100
01101111100111101110
11110001100100011111
11111111100111111111