00000000000000000000
00000000000000000000
00000000000000000000
00111111111111100110
00111111111111000110
00111111111110010100
00111111111111000000
00111111111111000000
00111111111001100010
00111111111110101110
00111111110111011110
00111111111010101110
00111110011101110110
00001111101010110110
00100111010110111110
00100000110110111110
00100111110111111110
00001111101111111110
00000000000000000000
00000000000000000000