01111111111100000000
01101111111100000000
01101111111100000000
01110111111100000000
00110111111000000000
00111011111000000000
00011111110000000000
00010111010000000000
00001000100000000111
00001000100000011111
00000101000000111111
00000101000000111111
00001111100001110111
00001011100001101111
00001111100001101111
00000000000001101111
00000000000001110111
00000000000000110111
00000000000000111011
00000000000000011011