00000000000000000000
00000000000000000000
00000000000000000000
00000000000011000000
00000000000011000000
00000000000011000000
00000000000110100000
00000000000110100000
00001000000110100000
00011100000110100000
00111110000110100000
00011101000111100000
00001110100111100000
00000111010111101010
00000011110000001010
00000001111000001110
00000000011100001110
00000000001111100000
00000000000000000000
00000000000000000000