00000000000011011000
00000000000111111100
00000000111011100110
00000000011111010001
01110000000110011101
11111111100100010110
11011000111000010000
11100000000000010000
10100000000000100000
00100001000000100000
00010001110100111100
00010001111110000110
00001011100011111110
00001011000000110010
00001101100111101110
00000110110011001100
00000011111100000000
00000001101100000000
01111000110000000000
11111110110111111111