00000100011000010000
01000110101100010000
11001100111100111000
01100110011001111100
11011111000001111100
11101100000000101000
01110111000001111000
11011110001011111100
11110100111111110110
11101101100001111011
01011111110000011111
11101110011111110010
01110100001000100010
11011101101000100010
11000101101000111111
01111111111111111001
11111110110011100000
11101001001000010100
10010110011111111111
01101100001010010100