00000001111110000000
00000011111111100000
00000111111111110000
00001111111111110000
00011111111111111000
00011100000111111000
00110000000111111100
00100000000001111100
00111111100001100100
00111101111111000100
00101100111101000100
00100000011101000100
00100000000000000100
00100000000010001100
00110110011110011000
00010011110000010000
00011000000000110000
00001100000001100000
00000111000111000000
00000001111100000000