00000000000000111100
00000000000001101111
00000000000001000110
00000000000001101100
00000000000000101100
00000000000001100110
00000000000011000111
00000000001111100011
00000000011100100011
00000000110000000011
00000001100101000111
00000011010110001111
00001101011000111110
00011010000111111110
01110011111011111100
10001000000111111000
11110011111111100000
00011110110110000000
00000000011011000000
11111100111101111011