00000000000001110000
00000000000011111000
00000000000011111110
00000000000011111110
01000000000011111110
01000000000111111100
01000000001111111000
01000000111111111000
01100001111111111000
01100011111111111000
00110111111111111000
00111111111111111000
00011111111110011100
00001111111111011100
00011100110111011100
00011101110111011100
00111001100011001100
01110001100111001100
01111001110111011100
01111001110000011100