10100000111111110000
01000000100000010000
10100000100001010101
00000000100011010010
00000000100000010101
00000000011111100000
00000000001111000000
00000000001111000000
00011000000110000000
01111111111111110000
11111111111110111000
10011000000011011000
11110011111001111000
11110111101101111000
11110111110101111000
11110111111101111000
11110111111101111000
11110011111001111000
11111000000011111000
01111111111111110000