00000000000001110000
00011110000011110000
01111110000011110000
11111110000011110000
11111110000011110000
11111110000000111000
01111110000000111100
00111110000000111101
00011000000001111101
01111110001111011101
11111111011100011101
11111111111100111101
10000100000111111101
10000100000111111101
10000100001111111111
10000100001101000001
10000100001101000001
10000100001101000001
10000100001101000001
10000100111101000001