00000000000011111111
00000000000000010001
00000000000011110001
00000100000000011001
00011111100000111111
00000100000001100101
00000000000100000101
00000000111111000101
00000000000100000000
00000000000000111000
00000000000001101000
00000100000011011100
00001110000011010100
00011111000011010100
00111011100001010100
01111111110001111100
00110001100000010000
00110001100000010000
00110001100000010000
11111111111111111111