00111100000000000000
01111111000000000000
11111111000000000000
11000111100000000000
10000011001111110000
11010000111111111100
01100011111111111110
00000111111111111110
00011111111100011111
00111111110000001111
00101111101000000111
00111111011000000111
01111110111000000111
01110110111000000111
11101100111100001111
11011000111100001110
00000000011110011110
00000000011111111100
00000000001111111000
00000000000111110000