00000000000000000000
00000001110000000000
00001111111000000000
00011111111100000000
00111111111100000000
00111111111110000000
00111111111110000000
00111110110010000000
00010000010010000000
00010110000010000000
00010000001110000000
00010000001111000000
00011100001001111000
00000100001000101110
00000111001000100010
00000010011001100000
00000011110001000000
00000000100111000000
00000001111100000000
00000001000000000000