00000000000000000000
00000000000000000000
00000000000000000000
00000000111110000000
00000011111111100000
00000111111111110000
00001111011011110000
00101111111111111000
01001111000111111000
01010100000001110110
01110101111101110010
00000110000011101100
00000011100111000000
00001111111111111100
00011111111111111110
00011100111111100111
00111000111111110011
00111000011111110011
00000000000000000000
00000000000000000000