00000000000000000000
00000000000000000000
00000011111100000000
00001110000111110000
00111000111001111100
00110111111110100110
00011111000111110000
01001111110010001100
00111001111011000000
01000111000111000000
01111100001110000000
00111000001110000000
00000000011011000000
00000011111111111100
00000011111111111100
00000001000000001000
00000001111111111000
00000000110000110000
00000000000000000000
00000000000000000000