00000000000000000000
00000001100011000000
00000001100011011100
00011111111111111100
00111101101010000000
00000001011100000000
00000000111111000000
00000001110011110000
00000111101101111100
00011110001100011100
00111000001101101100
00000111111111110000
00000000111110000000
00000001101111000000
00000011101101100000
00000111001101110000
00000000001100110000
00000000111100000000
00000000011000000000
00000000000000000000