11000111100011110000
11101111000110011000
11101110111101001100
01101100010100011110
00110100100011101111
10011000010011000011
11001000010110100101
11101000100110110101
01111100000110011001
00000110000111001011
11100011000011101011
11111001100001101010
11111101111100110110
01100011000111110110
00000101110000111110
01111000111001011101
11001110011001010101
11100110011001010101
11101110001000110101
01001100000000011110