00010101011010101000
00010101011010101000
01011111111111111010
01111111111111111110
01101000000000010110
01110000000000001110
01110110000001101110
11001001100110010011
11100000000000000111
10011111111111111001
11011111011111101011
01011000101100011010
00101111100111110100
00110000000000001100
00110000000011001100
00110000011110001100
00110000000000001100
00011000000000011000
00001100000000110000
00000111111111100000