00000000000000000000
00000000000000000000
00000000000000000000
00000000000111111100
00000001101111110000
00000000111111100000
00000000011000000000
00000111101101110000
00011100111111111000
00011000011111111100
00111000011111111100
00111101111111111100
00111111111111111100
00011111111111111100
00011111111111111000
00001111111111111000
00000111111111110000
00000001111111000000
00000000000000000000
00000000000000000000