00000000000000000000
00000000000000000000
00000000000000000000
00000110111000000000
00001001001100000000
00001011011110000000
00011011011111000000
00011111111111000000
00001111111110000000
00000100010011000000
00000111100011000000
00111010011111011100
00111111101001111100
00011110100001111000
00001111000011110000
01111101111110111110
00111100000000011100
00011000000000001000
00000000000000000000
00000000000000000000