00000000000000000000
00000000000000000000
00000000000111000000
00000000000111000000
00000011100110001100
00000011100110111100
00000111001111111100
00000111001100000100
00001110001001100100
00011110000001100000
00111110000001100000
01101100001001101000
01001100011001101110
00001100110001000111
00001101110001000011
00001100000011000000
00001100001111000000
00000100000110000000
00000000000000000000
00000000000000000000