00000000000000000000
00000011111110000000
00001110011111110000
00011001111111001000
00110111111111110100
00111111111111111100
00111111111111111100
00111101111100111100
00011010000011011000
00000100011111000000
00000100111111100000
00001000111111100000
00001000111111110000
00001001101111110010
01001001110110110110
01001001110110110100
01100100110101101101
00110111011011101011
00111011111111011110
00011100110011111100