00000011111111000000
00000111111111100000
00000111111111110000
00001111000000110000
00111110000000010000
00101111000000010000
00101111000000010000
00101111111111111000
00101111111101111000
01101111111000111000
01001111000000010000
01101111000011010000
00111010000000010000
00111111000111010000
00111111100000110000
01111110110000110000
01111110011111111110
01111011000001111111
01110001000000111111
01110000000000111011