00001110000000011100
00001011000000110100
00001001111111100100
00001111111111111100
00001111111111111100
00001111111111111110
00011110011111001110
00011100001110000110
00011101111111110110
00011101101110110110
00011111111111111110
00001111111011111100
00000111111111111000
01100010000000010000
01110011000000110000
00110110000000011000
00110110011101011100
00111110111111011100
00111110011101011100
00011111000000111100