11001111111010110011
10011000110101011001
00110001010100101100
11100100101000101110
01100100101001000110
01100000011111101111
10110001111111111001
10111111111100110110
10110001111000011000
00100110111000011000
01101001011100111001
01000001101111110111
11100000000111101001
11110000110001000101
11111111000101100101
01111100100110110001
00111000100010010011
01110001100010011111
10110011110000011111
00010011111100111111