00000000000000000000
00000000000000000000
00000001111110000000
00000111101111100000
00001111000111110000
00011111000011111000
00011110110001111000
00101101111000001100
00110011111100111100
00111011111101111100
00111101111001111100
00111100110000110100
00111011111111000100
00011100100100111000
00001100100100010000
00001100000000010000
00000111111111100000
00000011111111000000
00000000000000000000
00000000000000000000