00001001111111101000
00010111111111110100
00101111111111111000
00011100000110011100
00111000000011011100
00110000000001111100
00110110011001111100
00110110011001111100
00010100010001111100
00010000000001111100
00010111100001011100
00010011010000101100
00001000110000101100
00011000000011101100
00111000000111011000
00111000000110111100
00001000000001111000
00001000000000110100
00011111111111101000
00011111011111010000