00000000000000000000
00000000000000000000
00000000000001100000
00000000000010110000
00000000000010011100
00000001111001111110
00000111111111110111
00001111111101111111
00011110001110111110
00011101110111110000
00111111111111100000
01011111000011100000
01011111111101110000
01000111111110000000
01100000000000000000
00111111000000000000
00000001100000000000
00000000110000000000
00000000000000000000
00000000000000000000