00000000000000000000
00000000000000001110
00000000000000110110
00000000000001011110
00000000000001111100
00000000000000010110
00000000000000111100
00000111110000111000
00011111111000011100
00101100001100001110
00011001110110011110
00110011011111101110
00100110101110011100
00101101010111111000
00001010100011110000
00001010100110100000
00000010001100011000
00000000010000100100
00000000101100000000
00000000000000000000