00000000111001100000
00000001101001110000
00000011001001011000
00000010010001001000
00000010010011001000
00000001001100001000
00001111111110110000
00011000111111000000
00110001111101111000
00100011101101100100
00100101001000110010
10101001010001101011
10011011010001010001
11000011001011001111
11100011100110000000
10110011101100111110
11010011111001100011
01011011110011011101
00101001110100100101
00011110101111000011