00000000000000000000
00000000000000000000
00000000000000000000
00000010000111110000
00000011001111111000
00001111001111111000
00011110011111111100
00010111011111111100
00111111011111101100
00011111101111110000
00000111110111110000
00001111111111110000
00011111111111110000
00010111101111100000
00000111110111100000
00000111110111000000
00000011111110000000
00000111111000000000
00000000000000000000
00000000000000000000