00111100000000000000
01101111100000001100
11001111111100011000
10011111111111110000
10011111111111110000
10111111111111111000
11111111111111111110
01111111111111111111
00111111111100000111
00011111111011111011
00001111110111111101
00000111101110101110
00000000101100100110
00000011001111111110
00000011001100100110
01110011101110101110
11111001110111111100
11111000111011111000
11111000000000000000
01110000000000000000