00000000000000000000
00000000000000000000
00000000000000000000
00000110000000000000
00000110000000000000
00111111000000001000
00011111000000001000
00111111100000001000
01111111110000001100
01111011111100011100
00111011111111111110
00010011111111111110
00000111111111111110
00000111111111111111
00000111111111111111
00000111111111111111
00000111111110011111
00000011111000001111
00000000000000000000
00000000000000000000