00001111111111110000
00111111111111111100
01111000011000011110
01111000011000011110
11111100000010111111
11001100000110110011
11000000001100000011
11000000001100000011
11000000001000000011
11110000011100001111
11110000011110001111
11000000000111000011
11000000000001110011
11000000000000000011
11001100000000110011
11111100000000111111
01111000011000011110
01111000011000011110
00111111111111111100
00001111111111110000