00000000000000000000
00000000000000000000
00000000000000000100
00000000000000001100
00000000011110011100
00000011100111010000
00000111111011100000
00001100001101110000
00001001110110111000
00000010110110111000
00101110001110001000
00110111011101100000
00111011111101110000
00011011110111110000
00001100001111100000
00000011111011011000
00000111111000111100
00011011110001101100
00111000000011000100
00000000000000000000