01111110001110011111
00101111111111111010
00011011111111110100
00011111111111111100
00011011111111011110
00001111101110011111
00001111001111111110
00111111111111011111
00000111000110001110
00011110001010011111
00111111000101111100
00000001111111110000
00000000011111000000
00001111111111111000
01111111111101111101
11111100110001101111
11101110000011000111
01110110000010011111
00111011000100111101
11111100000101110011