00000000000000000000
00000000000010000000
00000001010110010000
00000000110011010000
00000000010101100000
00000000001100101000
00000000011111111000
00000000000001110000
00000000000000111100
00000111100001111110
00011111111111111000
00001111111111111000
00001111111111110000
00000111111111100000
00011111111111000000
00010011001101100000
00010110000100100000
00010011001100110000
00110001011000011000
00000001000000001000