0000000000000000000000000
0000000000000000000000000
0000000001111111100000000
0000000011111111110000000
0000000011111111110000000
0000000111111111111000000
0000001111111111111100000
0000011111111111111110000
0000000100000000001000000
0000001111111111111100000
0000000101111111101000000
0000000101110011101000000
0000000100000100001000000
0000000100001100001000000
0000000100000000001000000
0000000010000000010000000
0000000010011110010000000
0000000001001100100000000
0000000001100001100000000
0000011111011110111110000
0001111111011110111111000
0011111111101101111111100
0111111111101101111111111
0000000000000000000000000
0000000000000000000000000