0000000000000000000000000
0000000000000000000000000
0000110000000001100000000
0000011000000011000000000
0000001100000010000000000
0000000110000110000000000
0000000011001100000000000
0000000001111000000000000
0000000011111100000000000
0011111111111111111111100
0011111111111111111111100
0011000000000000001000100
0011000011111100001010100
0011000011111100001000100
0011000110110110001111100
0011000111111110001100100
0011000111111110001111100
0011000011001100001100100
0011000001111000001111100
0011000111111110001100100
0011001111111111001111100
0011001111111111001100100
0011111111111111111111100
0011111111111111111111100
0000000000000000000000000