0000000110000000111111000
0000000010000111111110000
0000000011001111111100000
0000000001011111110000000
0000000001100000000000000
0000000000100000000000000
0000111100101111100000000
0011011111111111110001110
0100011111111111111001110
0100111111111111001100011
1001111111111100000100011
1011111111111100001000011
1011111111111100001001111
1111111111111000111111110
1111111111111001111111000
1111111111111001101000000
1111111111111000001000000
1111111111111100001000000
0111111111111100000100000
0111111111111110001100000
0111111111111111111000000
0011111111111111111000000
0001111111111111110000000
0000111111111111100000000
0000001111011110000000000