0001100000000000000011000
0111100000000000000011110
0111101110000000111011110
1111111111111111111111111
0111101110000000111011110
0111101100001100011011110
0001101100011110011011000
0000001110011110111000000
0000001111001100111000000
0000000111111111110000000
0000000011111111110000000
0000000001111111100000000
0000000000111111000000000
0000000000011111000000000
0000000000011111000000000
0000000000011111000000000
0000000000011111110000000
0000000000011111111000000
0000000000111111111000000
0000000000111100111000000
0000000011111000011000000
0000001111110000011000000
0000011110000000011000000
0000011000000000011000000
0000011100000000011110000