0000000111000001100000000
0000000111100001100000000
0000000111100001110000000
0000000111100001110000000
0000000011000001110000000
0000001111111011100000000
0000111111111111100000000
0001111111111111100000000
0011111111111101100000000
0011100111110001100000000
0011000111111001100000000
0011100011111111100000000
0001100011111111111000000
0001110011111111111100000
0000110001111001111100000
0000000001111001101110010
0000000000111001100111110
0000000000111101100011100
0000000000011101100001000
0000000000001111100000000
0000000000001111100000000
0000000000000111101000000
0000000000000011111000000
0000000000000001110000000
0000000000000001100000000