0000000000000000000000000
0000000000000000000000000
0000000000000000000000000
0000000000111000000000000
0000000111100000000000000
0000000000110000000000000
0000000000111100000000000
0000001111100000000000000
0000000011111100000000000
0000000000011111110000000
0000000000001100000000000
0000011111111111111111100
0000011111111111111111110
0000011111111111111100110
0000011111111111111100110
0000011111111111111100110
0000011111111111111100110
0000011111111111111101110
0000011111111111111111100
0000011111111111111100000
0011111111111111111111100
0011111111111111111111100
0000001111111111111000000
0000000000000000000000000
0000000000000000000000000