0011100000000000000000000
0111100000000000000000000
0111000000000000000000000
0111000000000000011111100
0111000000000000111101110
0111000000000001111101111
0111000000000011110101011
0111000000000011111000111
0011100000000011110010011
0011111111111111110000011
0000100011111011110010011
0001101111111011111111111
0001001111111001110000111
0001001111111101110000110
0001001111111100000000100
0001001111100000000001100
0001000000000000000001000
0011000011110000000011000
0110000110011111100110000
1100001100000000110100000
1111111000000000111100000
1110111000000000011100000
0110011000000000011100000
0111011100000000011110000
0011101110000000001111000