0000000000000011000000000
0000000000000111100000000
0000000000011111100000000
0000000001111111100000000
0000000011111111111110000
0000000000000111111111100
0000000000001111111111110
0000000011111111111110011
0000001111111111111110011
0000011111101111111111110
0000111111001111111111100
0000111111000111111111000
0001111111000111111110000
0001111111000011111000000
0011111111000010001000000
0111111111000110011000000
1111111111011110011000000
1111111111001110000000000
0111111111000100000000000
0111111111000000000000000
0011111110000000000000000
0001111110000000000000000
0001111110000000000000000
0000111100000000000000000
0000001100000000000000000