0010000000000000000000000
0011110000000000000000000
0111111100000000000000000
0111111110000000000000000
0101111110000000000000000
0111011111000000000000000
0111011111000000000000000
0111011111111111110000000
0000011111111111111111000
0000011111111111111011100
0000011111111111111001110
0000011111111111111000110
0000001111111111111000110
0000001111111111111110110
0000001111000001111110110
0000001110000000011110000
0000011100000000000111000
0000011000000000000111000
0000111000000000000011000
0000110000000000000011000
1111110000000000000011111
1111100000000000000011111
0011111110000000111111100
0000111111111111111110000
0000000011111111100000000