0000000001111111110000000
0000000000000111111100000
0000000000000001111110000
0000000000000001111110000
0000000000000111111110000
0000000000011111111100000
0011000000111111110000000
0011100001111111000000000
0001110001111000000000000
0000011000110000000000000
0000001100011000000000000
0000000110000000000000000
0000111111111111111110000
0000111111111111111111111
0000111111111111111110001
0000011111111111111100001
0000011111111111111100011
0000001111111111111001110
0000001111111111111111000
0000000111111111110000000
0000000011111111100000000
1111111111111111111111111
0011111111111111111111100
0000011111111111111100000
0000000011111111100000000