1000000000000000000000000
1100000000000000000000000
1110000011110000000000000
0111000111100000000000000
0011001111000000000000000
0001111000000000000000000
0011111100000000000000000
0101011110000000000000000
0111111110000000000000000
1000111111000111111000000
1000101111111111111111000
1000101111111111111101100
0111001111111111111100100
0000001111111111111100100
0000001111111111111100100
0000000111111111111100110
0000000111111111111100011
0000000011111101111110011
0000000011100000111110001
0000000011100000110110000
0000000011000000110110000
0000000011000001110110000
0000000011000001100110000
0000000111000011101110000
0000000110000011001100000