0011111000000000000000000
0111111100000000000000000
0101101110000000000000000
1110011110000000000000000
1000000111000000000000000
1000000111000000000000000
1000000111100000000000000
0101101111100000000000000
0101101111110000000000000
0101101111111000000000000
0101101111111110000000000
0101101111111111100000000
0101101111111111111000000
0101101111111111111100000
0111111111101111111110000
0011111111110111111111000
0011110111110111111111000
0011110111110111111111100
0001110111110111111111100
0001011011110111111111100
0000101011101111110111100
0000110011101111101111100
0000111011110011101111000
0001111111111100110111100
0111111001111111011011111