1111111111100000000000000
0011111111111000000000000
0000111111111100000000000
0000001111111110000001000
0000000111111110000111000
0000000111111110001111100
0000000011111110011111110
0000000011111110111111111
0000000001111101111100011
0000000000011111111100000
0000001111111111111000000
0001111111111111111000000
0011011111111111111000000
0011011111111111111000000
0111011111111111111000000
0110011111111111111100000
0110001111000000111110000
1110001111000000000111000
1100011111000000000101000
0000011011000000000101000
0000010011000000001101000
0000010001100000000011000
0000010000100000000000000
0000011000110000000000000
0000001100011000000000000