0000000010000000000001000
0000000111000000000011100
0000000010000000000001000
0000000010000000000001000
0000000111000000000001000
0010001111100010000001000
0111011111110111000011100
0010011111110010000010100
0010001111100010000010100
0111001010100111000011100
1111101010101111100111110
1111101111101111100101010
0111001111100111000101010
0101001111100101000111110
0101111111111101000111110
0111111111111111000101010
0111111000111111000101010
0100010111010001001111111
0011101111101110000111110
0111111111111111100111110
0110111000111011110111110
0110110111011011011111110
0111110101011111001110110
0111110101011111100110110
0111110101011111110110110