0000000001111111000000000
0000000011111111110000000
0000011111011011111100000
0000111110010001110110000
0000111100010001100011000
0011110000011011101111100
0011111100011101101111100
0111111100011110110111110
0111111100011111000111010
1111111100011110111010111
1111111100011101111101111
1111111100011101111110111
1111111100011110011111011
1111111100011111001111011
1111111100011111111111011
1111111111111111111111011
0111001010100110010111010
0111001000101101010110110
0011011110100101010010100
0011011000100101010011100
0001111111111111111111000
0001111111111111111100000
0000011111111111111100000
0000000111111111110000000
0000000001111111000000000