0000001000000000100000000
0001111111111111111100000
0111111111111111111111000
1111101010000010101111100
1111100010000010001111100
1111110011000110011111110
1111110001111100011111101
0000000000010000000000001
0000000000010000000000001
0000000111111110000000001
0000011111111111100000001
0000111111111111110000001
0000111110000011111000011
0001111100101001111000010
0001111000000000111100010
0001111010111010111100110
0001111000111000111100100
0011111010111010111100100
0011111000000011111110100
0011111100101001111110110
0011111110000011111110011
0011111111111111111110001
0011111111111111111111111
0011111111111111111110000
0000001111111111100000000