0000000001100000000000000
0000000001100000000000000
0000000001100000000000000
0000011111111111111111111
0000010000000000000000001
0000110111101111101111101
0000100111101111101111101
0001101111101111101111101
0001001111101111101111101
0011011111101111101111101
0010000000000000000000001
0111111111111111111111111
1100000000000000000000001
1000000000000110000000001
1000000000000110000000001
1000000000011111100000001
1000111110011111100111111
1001100011000110001100011
1111011101100110011011100
1110111110110000110111110
0001111111011111101111111
0001110111000000001110111
0001111111000000001111111
0000111110000000000111110
0000011100000000000011100