0011111111111111110000000
0110111111111111111000000
0111011111111111111100000
0111101111111111111110000
0111110111111111111111000
0111111011111111111111100
0011111101111111111111110
0001111111111111111111111
0000111111000000000000010
0000011110000000000000100
0000001110000000000000100
0000000110000000000000100
1110000011000000000000010
1010000001111111111111111
1011000000000000000000000
1001000000011100000000000
1001100000010111000000000
0000100000010001110000000
0000110000010000011100000
0000010000000000000111000
0000011111111111111111110
0000001000000111100000010
0000001000000100100000010
0000001100001100110000110
0000000111111000011111100