0011110000000000000000000
1110011100000000000000000
0110011000000000000000000
0011110000000000000000000
1110011100000000000000000
0110011000000000000000000
0011110001111111111111100
1110011101000101101010100
0110011001101000110110100
0011110001101010101010100
0001100001111111111111100
0001100000010000000010000
0001100000111111111111000
0001100000100000000001000
0001100001100000000001100
0001100001000000000000100
0001100111111111111111111
0001100110011111111110011
0001100100001111111100001
0001100100001111111100001
0001100110011111111110011
0001100111111111111111111
0001100001100000000001100
0001100001100000000001100
0001100001100000000001100