0000000000000000000000000
0000000000000000000000000
0000000000000000000000000
0000000000000000000000000
0000000110000000001111000
0000001111000000011110000
0000001011100000111111000
0000000100100011111110000
0000000100100111111100000
0000000000101111111110000
0000000001100111111000010
0000000011011011111001100
0000000110111101111111110
0000000111111111111111110
0001110111111111111111100
0011011111111111111111100
0010101111111111111111100
0010101011110000001111010
0010111101101111110111010
0011011111011111111001110
0001100000111100101111110
0000111111110010011111110
0000000000000000000000000
0000000000000000000000000
0000000000000000000000000