0000000000000000000000000
0000000000000000000000000
0000000000000000111000000
0000000000000001111110000
0000000000000011111111000
0000000000000111111111100
0000000000001111000111110
0000000000001110111011111
0000000000011110111101111
0000000000011101111110111
0000000000111101101110111
0000000000111101010110110
0000000001111011011101110
0001000001111011011011100
0010100011111011100111100
0000100011110111111111000
0001100111110111110011000
0011100111110111100110000
0111111001101111001000000
0011111110000000001000000
0000111111111111110000000
0000001111111111111100000
0000000111111111111111100
0000000000000000000000000
0000000000000000000000000