0000000000011100000000000
0000000001110000000000000
0000000011011100000000000
0000000010000000000000000
0000000010000000000000000
0000000010000000000111000
0000000011111100111111000
0000000010000111001000000
0000011111110001101000000
0001111111111100111000000
0011101111011110011000000
0111101111011111001100000
0111110110111111000100000
1111110110111001100110000
1100111010100111100010000
1111000111011111100011000
1111111101111111100001000
1111110111000111100001000
1111001010111001100011100
1100111011011111100111110
0111111011011111001111111
0111110111101111001110111
0011110111101110001111111
0001111111111100000111110
0000011111110000000011100