0000000000000000000000000
0000000000000000000000000
1111111111110011111111111
1111111110000000011111111
1111111000000000000111111
1111100000000000000011111
1111000000000000000001111
1110000000000000000000111
1110000000000100000000011
1100000000001100000000011
1000000000111100000000001
1000000000011100000000001
1000000000111100000000000
0000000011111000000000000
0000000111111000000000000
0000000111111000000000000
0000001111110000000000000
0000011111110000000000000
0000011111010000000000000
0000011111010000000000000
1000011110010000000000001
1000011111011000000000001
1111111111111000000000011
0000000000000000000000000
0000000000000000000000000