0000000000000000000000000
0111111111111111111111110
0111000001111111000001110
0110000000111110000000110
0100000000011100000000010
0100011100011100011100010
0100010100011100010100010
0100011111111100011100010
0100000000000100010000010
0110000000000100010000110
0111000000000100010001110
0111111111111100011111110
0111111100010100011111110
0111111100011111111111110
0111000100010000000001110
0110000100010000000000110
0100000100010000000000010
0100011100011111111100010
0100010100011100010100010
0100011100011100011100010
0100000000011100000000010
0110000000111110000000110
0111000001111111000001110
0111111111111111111111110
0000000000000000000000000