0000000000001100000000000
0000000000011110000000000
0000000000011110000000000
0000000000011110000000000
0000000000000111111000000
0000000000001111111110000
0000000000001111111111100
0000000000001111111011110
0000000000011111111000110
0000000000011101111100011
0000000000011001111100011
0000000000011001111100001
0000000000111001111100000
0000000001110011111100000
0000000011100111111100000
1000000110001111111000000
0001111100011110111000000
0011001000011110111000000
0110001000001111110000000
0100011000000011110000000
0110110000000001111100000
0011100000000001101100000
0000000000000001101000000
0000000000000011001000000
0000000000001111000000000