0000000000001000111110000
0000000000011111110100000
0000000001110111000100000
0000000111111100000100000
0000111110001000001110000
0000010000001000001010000
0000010000001000001010000
0000010000001000011011000
0000111000001000010001000
0000101000001000010001000
0000101000001000110001100
0001101100001000100000100
0001000100001000100000100
0001000100001001100000110
0011000110001001000000010
0010000010001011111111111
0010000010001001111111110
0110000011001000111111100
0100000001001000001110000
1111111111101000000000000
0111111111001000000000000
0011111110001000000000000
0000111000011100000000000
0000000011111111100000000
0000011111111111111100000