0000011111111100000000000
0000111101110110000000000
0000111000100010000000000
0001111010101010000000000
0001111010101010000000000
0001111010111111000000000
0001111111000001111000000
0001111100000000001110000
0001110100000000000011000
0000110010000000000000100
0000110001111111111000010
0000011000000000001111111
0000001111111111110000000
0000000011000000000000000
0000000011000000000000000
0000001111100000000000000
0000011111110000000000000
0010111111111000000000000
0111111111111000000000000
1111111111111000000000000
0001111111110000000000000
0000011111100000000000000
0000001110000000000000000
0001111011110000000000000
0010101010101000000000000