0011100000000000000000000
0100000000011100000000000
1110111001111110001111100
1010101011111111011000000
1110111000000111011001100
0000010001111111010011110
0011100000000001010110001
0000000000000011111101100
0001000000110111111011110
0011000000011111111110001
0011010010110111111101100
0111010011111111111111110
0111010001011111111110011
0111010011111111111110001
0111110111111111111110000
0011110111111111111110000
0000111111111111111100000
0000000011111111111100000
0000111111111111111000000
0001100110111111110000000
0001101101101111000000000
0001011011011000000000000
0001011011011000000000000
0001001101101100000000000
0000000010110110000000000