0000000000000000000000000
0000000000111110000000000
0000000001111111000000000
0000000011111111100000000
0000000111111111110000000
0000000111111111110000000
0000000111111111110000000
0000000111111111110000000
0000000111111111110000000
0000000011111111100000000
0000111111111111111110000
0001111111111111111111000
0011111111111111111111100
0111111111111111111111110
0111111111111111111111110
0111111111111111111111110
0111111111111111111111110
0111111111111111111111110
0011111111111111111111100
0001111111011101111111000
0000111110011100111110000
0000000000011100000000000
0000000000011100000000000
0000001111111111111000000
0000001111111111111000000