0000000000000000000000000
0000000011111100000000000
0000001111111111000000000
0000011000000011100000000
0000110011110001110000000
0001101111111100111000000
0001011100011110111000000
0001110000001110011000000
0011100000100111011100000
0011000000110111111100000
0110000000111111111100000
0100000000111111111110000
1100000000011111111110000
1000000000001111100111000
0000000000011111101111000
0000000000111111111111000
0000000001110111111111100
0000000001100011111111110
0000000011011011111111111
0000000010011100111111111
0000000110111111111111111
0000000101111111110001110
0000001101111111000001110
0000011001111111000001100
0000111011111111000000100