0000000000111111000000000
0000000001111110000000000
0000000011110000000000000
0000000010000000000000000
0000000000000001111111110
0000001111000011111111110
0000001111000001000100100
0000001111000001000100100
0000000110000001000100100
0000000110000001000100100
0000111111111111000111100
0001011111111101000111100
0011011111111101111111100
0011011111111101111111100
0011010000000101111111100
0001010000000101111111100
0000111111111111111111100
0000100000000000010001100
0001111111111111101110111
0011100011100011011111011
0111011101011101111111100
1110111110111110111011100
1110110110110110111111100
0000111110111110011111000
0000011100011100001110000