0000000000000000000000000
0000000000000000000000000
0000000000011100000000000
0000001100111100100000000
0000011110111100111100000
0000011110111110111111110
0000011111111110110111111
0000011101111110111111111
0000111111111110011110000
0011111111111111001110000
0111111111111111111111000
0101111011111111111111000
0101111011111111111111000
0100111101111011111111000
1100101111110111011111000
1001101110111110110000000
1001111100011111111000000
0011101100011110001100000
0011101100001110001100000
0011001100001100000110000
0011000110001100000110000
0011000110001100000110000
0011100111001110000111000
0000000000000000000000000
0000000000000000000000000