1111111110011111111100111
0000000001110000000111000
0000000111000000000001110
0000001111111111111111111
1000000000000100010000000
1111111111110111010000001
1000000001100100010000011
1011111111000111010000111
1010010000000100010001101
1010110000000111010011001
1011100000000100010110001
1010000000000111011100001
1010000000000100011000001
1110000000000110110001001
1110000000000101100011001
0100000000000111000111001
0000000000000110001101001
0000000000001100011001001
0000000000011000111111001
0000000000110000000000001
0000000001100000000000001
0000000011111111111111111
0000000000000100010000000
0000000000000111010000000
1111111111110100010111111