0000000000000000000000000
0000000000000000000000000
0000000000000010000000000
0000000000000111100000000
0000000000000101111111100
0000000000000110111100100
0000000000000110110011100
0000000000001111001111100
0000000000011100011111100
0000000000110011101111100
0000000000101111101111100
0000000000011111110111100
0000000000000111111011100
0000000000000001111011100
0000000000000000011101100
0000000000000000001101100
0000000000000000000110100
0000000000000000000010100
0000000000000000000001100
0000000000000000000000100
0000011111100000000000100
0001111000110000000001100
0011100000011000001111000
0011000000001111111000000
0000000000000000000000000