0000001111111111111111111
0000011111110000110101011
0000111111111111111111101
0001000001111111000001101
0011111111111111111110101
0101010100000100000110101
1111111111111111111110101
1000001101011000001110111
1000001010111000001110101
1000001101011000001111101
1000001010101000001110101
1000001101111000001111101
1111111111111111111010101
1111111000001101111011111
1111111000001010101010111
1111111000001111011011111
1111111000001010101010111
1111111000001101011110111
1111111111111111111010111
1000001111111010101110110
1000001111111101011010100
1000001111111010101111000
1000001111111101011010000
1000001111111010101100000
1111111111111111111000000