0000000000000000000000000
0000000111100001111100000
0000001100110111101100000
0000011111011101011100000
0000011110100010001100000
0000001011111111100100000
0000001011001000111110000
0000011110001000001011000
0000110100000100001101000
0001101100000100000101110
0001111000000100000110110
0011101000000100000010010
0010111000001110000111111
0011001000001110000100011
0111011100000100000101101
0111010110000100001110111
0100010011011111011010101
0100011001111111100110011
0111001100010001001100110
0011000111100000111000110
0001111000000000000101100
0000111100000000011111000
0000000111100000110000000
0000000001000000100000000
0111111111111111111111111