0000000000000000011000000
0000000000000000111100000
0000000000001111111111110
0000000000000000111100000
0000000000000001111100000
0000000000000000111100000
1111110000000000011100000
0100011110000000011110000
0100000011100000011111000
0100000000110000011111000
0100000000011111111111100
0100000000000111111111100
0100000000000000001111100
0100000000000000111111100
0100000000000001111111001
0100000000000001111111111
0100000000000001110111111
0100000000000000110111111
0100000000000000111111111
0100000000000001111111111
0100000000000011111111111
0100000000000000001111111
0100000000000000011111111
1100111001110011111111111
0111001110011100111111111