0000000011110000000000000
0000000111111000000000000
0000000101111100000000000
1000011111111110000000000
1100010011111110000000000
0111000111111111000000000
0111000001110000000000000
0111100111111100000000000
0110111111111111000000000
0111011111111111100000000
0011111111111111110000000
0011111111111011110000000
0001111111111111100000000
0000110111111111000000000
0000000111111100000000000
0000011111111111000000000
0000011111111111000000000
0000011111111111000000000
0000011111111111000000000
0000011111111111100000000
0000001111111110110000000
0000001111111110011100000
0000001111111110001111000
0000000111111100001111110
0000000111111100000111111