0000000000000111100000000
0000000000111111111100000
0000000011100100100111000
0000000110001100110001100
0000000100001000010000100
0000001100011000011000110
0000001000010000001000010
0000011000010000001000011
0000010000110000001100001
0000010000100000000100001
0000010000100000000100001
0000010000100000000100001
0000011111111111111111111
0000010000100011000100001
0000000000000011000000000
0000000000000011000000000
0000000000000011000000000
0000000000000011000000000
0000000000000011000000000
0000000000000011000000000
0010000000000011011111100
1111100000111111110000111
0011111001100011000000001
1111101111001111110110011
0010000000011111111011110