0000011100000110001110000
0000111100000010001100000
0000111100000011001010000
0000111100000001000001101
0000011000000001000001110
1111111111111111111000111
1111111111111111100001011
0001111110000001000000000
0000111110000001000000000
0000111111111110100000000
0000111111111101111000000
0000111111111101111100000
0000011111111011111010000
0000011111111011111011000
0011111111110111111011000
1111111111111111110011100
1000001110000111110011100
1100001100000011111001100
0100001100000000111101100
0110011000000000111101000
0110011000000001101001000
0000010000000001011000000
0000110000000011010000000
0001100000000110110000000
0001100000000110110000000