1111111000000000001111111
1111100000000000000011111
1111000011110000000000111
1110000000011000000000011
1100001111001000000000011
1000000111100001111110001
1000000011100111111111001
1000000000011111111111111
0000000000011111111111111
0001000000011111111111111
0001100000001111111111111
0001110011001111111111111
0001000010000011111111111
0000010001000001111111111
0000010001100001111111111
0000011000111111111111111
1000001100011111111111111
1000000111111111111111111
1100000011111111111111111
1110000000011111111111111
1110000000001111111111111
1111000000000111111111111
1111100000000011111100111
1111111000000000000001111
1111111111000000001111111