0000000000000000000000000
0000000000001111111100000
0000000000111000000111000
0000000001100011111001100
1000000011000111111100100
1100000010011111111100110
1110000010111111111100011
1111000110111111100000001
0111111100001110001100001
0011110000000000111111001
0001111000000001111111001
0011111111000001111111101
0110011110100000001111101
1100111101100001110111001
1000101010100011111000001
1000110101000111111100011
1000011110000111111110010
1000000001110111111110110
1000000011111001111100100
1100000111111110001101100
0110000011111111100011000
0011000011111111100110000
0001110000111100011100000
0000011100000001110000000
0000000111111111000000000