0000000000000000000000000
0000000000000000000000000
0000000000000000000001000
0000000000000000000010000
0000000000111000110110000
0000011000111101111110000
0000011000111101101110000
0000011000001111101110000
0000011000011111111110000
0000111000111111111100000
0000110001111101111100000
0001100001111001111000000
0001100000110011110000000
0011000000000011111001100
0011000000000111111011100
0011000000111111111111110
0011000000111111111100100
0011000001111111111000000
0011000001111111111000000
0001100001111111111000000
0001110000111111110000000
0000111100111111100000000
0000011111111111110000000
0000000111111111111110000
0000000000000000000000000