0000000000000000000000000
0000000000000000000000110
0000000000001110000001110
0000000000001110000001110
0000000000001110000001110
0000000000001111111111110
0000000000001111111111110
0000000000001111111111110
0000000000001100001111110
0000000000010000000011110
0000000000110000000011110
0000000011111111110111110
0000011111111111111111110
0000111111111111111111110
0001111111111111111111110
0011111111111111111111110
0011111111111111111111110
0011111111111111111001110
0011111111111111110001110
0011111111111111100001110
0011100000001111000000000
0011100000001111000000000
0011100000001111000000000
0011100000001111000000000
0011100000001110000000000