0000000001000000000000000
0000000001010000000000000
0000000011111100000000000
0000000111111010000000000
0000000110111111000000000
0000000111111110000000000
0000001111101111000000000
0000001110011101000111000
0000001101111110001111000
0000000011111100001111100
0000000111111111111111100
0000001111111011111001100
0000011111110110011101100
0000011111110110111100100
0000011111110110111100000
0000111111110110111100000
0001110111101111111000000
0001000001111100111000000
0011000011011000110000000
0010000010010000010000000
0010000110100000100000000
0011000100100000100000000
0011001001100001100000000
0000011011000001100000000
0000011011000000000000000