0000000000000000000000000
0000000000000011111110000
0000000000001110010011100
0000001110011000100000100
0000011111010000100010000
0000111111000000110101000
0001111110111000010101000
0001111101111100001110000
0000100001111110000100000
0000011101111110000110000
0000111110000101100011000
0001111101111011110001000
0001111011111101111001100
0001110011100101111000100
0000101101011011111010100
0000011110111101111001000
0000111101111110110000000
0000111100011110000000000
0000111101101110000000000
0000011011110100000000000
0000000111110000000000000
0000000111110000000000000
0000000111110000000000000
0000000011100000000000000
0000000000000000000000000