0000000000000000000000000
0001100000000000000000000
0001100000000000000000000
0111111000000000000000000
0111111000000000001100110
0001100000000000001111110
0001100000000000001111110
0001100000000000000111100
0001100000000000000011000
0001100000111111100000000
0001100011111111111000000
0001100111111111111100000
0000000111111111111100000
0000000110001010011100000
0000000110101010101100000
0000000110011010011100000
0000000110101010111100000
0000000110101010111100000
0000000111111111111100000
0000000111111111111100000
0000000111111111111100000
0000000111111111111100000
0000000111111111111100000
0000000111111111111100000
0000000111111111111100000