1111111000111110001111111
1111110111111111110111111
1111001111001001111001111
1110111110001000111110111
1101110010001000100111011
1101110011001001100111011
1011011001001001001101101
0110001101101011011000110
0111000110111110110001110
0111110011111111100111110
1100011111100011111100011
1100000011000001100000011
1111111111001001111111111
1100000011000001100000011
1100011111100011111100011
0111110001111111000111110
0111000011111111100001110
0110000110101010110000110
1011001101101011011001101
1101111001001001001111011
1101110011001001100111011
1110111010001000101110111
1111001111001001111001111
1111110111111111110111111
1111111000111110001111111