0000000000000000000000000
0000011000010000110011100
0000111000111000111011100
0001111111111111111100100
0001000000000000000100100
0001000000000000000100100
0001011111111111110100100
0001010001000101010100100
0001010101010100010100100
0001010001000101010100100
0001010101010100010110100
0001011111111111110111100
0001000000000000000111100
0001000011111110000110000
0001000000000000000100000
0001000000000000000100000
0001000111111111100100000
0001000100000000100100000
0001000100000000100100000
0001000101111110100100000
0011000111000011100110000
0010000111111111100010000
0011111111111111111110000
0011111111111111111110000
0000000000000000000000000