0000000000000000111000000
0000000000000011111000000
0000000000000011111000000
0011000000000111111000000
0011000000000111111000000
0111000000000111111000000
1111000000000111111000000
1111000000000110011000000
1111100000001110001000000
1111100000001110001000000
1111111000001110001000000
1111111100011110001000000
0111001100011100011000000
0111101100111100010000000
0011100110110000110000000
0001110001110000100000000
0000110011000001100000000
0000011011000001000000000
0000001011000011000000000
0000000011110000100011100
0000111000000000111110110
0011100000000001111111111
0011111000000001000000000
1000111100001110000000000
1111111111111000000000000