1111111111111100111111111
1110011111111000011111011
1100111111110011111111111
1001111111101111111011111
1001111110111111111111111
1001111100011111111111110
1100111110111111111111111
1110011111111100110011111
0111111111110000000011111
1111111111001001100100111
1111101110010011001100011
1111111110110111001000011
1111111100100110011000001
1111111101101110010000001
1111111101001110010000001
1111111101011100110000001
1111111101011100100000001
1111111101100011100000001
1111110111111111111111110
1111110000000000000000000
1111110111111111111111110
1111111000000000000000001
1111111000000000000000001
1111111000000000000000001
1111111000000000000000001