0000000000000000000000000
0000000000000000000000000
0000000001001000000000000
0000000001011000000000000
0000000011111000000000000
0000000011111000000000000
0000000111111100000000000
0000000111111010000000000
0000001110111011000000000
0000011111111010100000000
0000100011110111010000000
0001111101101111101100000
0001010110011111110111000
0001111111111111111111100
0000111010011111111111100
0000000010001111111111100
0000000001111111111111000
0000000000001111111100000
0000000000001111111000000
0000000000001111110000000
0000000000000111100000000
0000000000000111000000000
0000000000000011000000000
0000000000000000000000000
0000000000000000000000000