0000000000000000110000000
0000000000000111110000000
0000000000011111111000000
0000000111111111111000000
0000001111111111111000000
0000001111111111111000000
0000001111111100011000000
0000001100001101100000000
0000001101100001100000000
0000000011111111100000000
0000000011111111100000000
0000000011111111100000000
0000000011111111100000000
0000000011111111100000000
0000000011111111100000000
0000000111111111100000000
0000000111111111100000000
0000000111111111100000000
0110000111111111010000000
1111110111111110111000000
0110011111111111010100000
0000000111111111101111100
0000000111100111111111110
0000000111100011111111110
0000000111100001111111111