0000000000000000000000000
0000000000000000100000000
0000000000000000110000000
0000000000000000111000000
0000000001111011011000000
0000000011111101111000000
0000000111000000111000000
0000000111111000011000000
0000000110000000011000000
0000110010010010011000000
0001111011001100110000000
0001001101011110110000000
0010000101111111110111100
0001111111111111101100110
0011001111111111110011010
0110100111111111101100111
0101111111111111110000100
0011001111111111101111010
0110111111111111110001110
0101101111111111111110100
0101100111111111011011010
0001000000001110000001110
0001000000000000000000100
0001000000000000000000100
0000000000000000000001000