0000000000000001111111111
0000000000001111111000000
0000000000011111000000000
0000000000111100001110000
1110000001110000111011000
1011111111100011100011100
1100000011000110000001110
1110000111000100111100111
0111100110000101111110011
0011111110000001111111001
0000111110000000001111001
0000000110000000000110011
0000000110000011000000110
0000001110000111100001101
0000111100000110100000001
0001110000000000000000001
0011111000000000000000001
0011111100000000000000001
0010100110000000000000001
0010100110000000000000011
0011111110000110000000011
0001111100011110000000011
0000111111111000000000111
0000000011110000000011110
0000000001111111111111100