0001100000000011100000000
0001100000001111111000000
0010010000011111111100000
0010010000000111111110000
0110011000110011111111000
0101101001010111111111000
1111111101101111111111000
1100001100000000001111000
1001100101111111110011000
1010110111111110011101000
1010010111000110011010100
1001100101100000001000100
1100001101000000011001100
0111111001000000010011100
0101011000111000110011000
0101011000100001100001000
0101011000111111000001100
0101011000100110000011100
0101011000011110000111110
0101011000000110001111111
0101011111111100011111101
0101011000001100111111011
0101011111111101111110111
0101011010111011111110111
0101011010110011111110111