0000000000011000000000000
0000000000011000000000000
0000000000001011000111000
0001111001101011011111100
0011111101101010011111100
0011111110101010111111100
0011111110101010111011000
0001101111111111111000000
0000001110101010111000000
0000011110101010111100000
0000111100101010011110000
0001111000101010001111000
0011110000101010000111100
0111110000101010000111110
0111100000101010000011110
1111100000101010000011111
1111100000101010000011111
1111100000101010000011111
1111110000101010000111111
1111111100101010011111111
0111111111111111111111110
0011111111111111111111100
0000111111111111111110000
0000000111111111110000000
0000001111111111111000000