0000100111101100000000000
0000111011011111100000000
0110011111111011111000000
0011111111111101011100000
0001111111011101011110000
0011111011101110101111000
0110111101101111011111000
0101111101110111011011100
0101110011110111101011110
1001110011110111100111110
0000111111110111110101111
0000111111110111110101111
0000111111111111110101101
0000111111101111110010101
0000111111000111111010101
0000111110000111111010101
0001101010000111111010110
0001111010000111111001010
0000110100000111111101011
0000000000000111111110011
0000000000000111111111101
0000000000001111111111110
0000000000011111111111111
0000000000011111111111111
0000000000011111111111111