0000000001111000000000000
0000000011001100000000000
0000111010000100000000000
0001100110010110001000000
0001000011001110101000000
0001001011111010101010000
0001100111100010111110000
0000111111000110011000000
0000111100001111110000000
0000111111111101100000000
0000011011111001000000000
0110001001110001100001101
0010001000000011101001110
0010011100000011111011110
1111111110000011111011111
0111001111100111101011110
0101000111111111101111100
0101010011111111001111000
0000011001111100001110000
0000111111100000001000000
0000111000000000000000000
0000011111000000000000000
0000011111100000000000000
0000001111000000000000000
0000001011100000000000000