0000000000000000000000000
0000000000000000000000000
0000000000111111000000000
0000000011111111110000000
0000000111101011111000000
0000001111011010111100000
0000011110010110111110000
0000011100010000101110000
0000110000000000000011000
0000110011110011110011000
0000100001100001100001000
0000100001100001100001000
0000100000000000000001000
0000100000000000000001000
0000110000001100000011000
0000010000001100000010000
0000011000000000000110000
0000001001100001100100000
0000001100110011001100000
0000000110011110011000000
0000000011001100110000000
0000000001100001100000000
0000000000110011000000000
0000000000011110000000000
0000000000000000000000000