0000000100000000000100000
0000000100000000000100000
0000001110000000001110000
0000001010000000001010000
0000011111000000011111000
0000111111100000111111100
0001111111110000101111100
0001011111110000101111100
0001011111110000101111100
0001011111110000111111100
0001011111110001111111110
0001011111110010111111111
0011111111111011111111111
0011111111111000111111100
0111111111111100000110000
1011111111111110000110000
1111111111111110000010000
0111111111111100000010000
0000111111100000000011000
0000000110000000000001000
0000000110000000000001100
0000000011000000000000110
0000000001110000000000011
0000000000011110000000000
0000000000000011111000000