0000000000011100000000000
0000000001110111000000000
0000000011001001100000000
0000000110110110110000000
0000000101000001010000000
0000000110000010110000000
0000000100000010010000000
0000000110000100110000000
0000000010000100100000000
0000000011000101100000000
0000000001001001000000000
0000000001101011000000000
0000000100111110000000000
0000000100111110000000000
0000000100011100000000000
1111111100011100011111111
0001100000011100000011000
0011111111111111111111100
0010000000000000000000100
0011111111111111111111100
0110000000000000000000110
0100000000000000000000010
0110000000000000000000110
0011111111111111111111100
0001100000000000000011000