0000000010000000000100000
0000000110000000000110000
0000000110000000000110000
0000000111000000000110000
0000000111100000001110000
0000000011100000011100000
0000000001111111111000000
0000111101111111111101111
0000101111111111111111101
0000110111111111111111011
0000011011100111111110110
0000001111100111001111000
0000000111110111101110000
0000000111110111101110000
0000111111111111111110000
0011111100000000000011000
1111111000011100111001000
1111111000011100111001000
1111111000000000000001000
1111111100000000000001000
1111111110000111100011000
1111111111000011100110000
1111111111111111111100000
1111111111111100000000000
1111111111111100000000000