0000111110000000000000000
0001100011000000000000000
0011000001100000100010001
0010000000100000100010001
0011111111100000100010001
1111111111111000110010011
1111000001111110010010010
0010000000100111011010110
0010010010100000001111100
0010000000100000000010000
0011001101100000000010000
0001100011000000000010000
0000111110000000000010000
1111100011111100000010000
0110000000110110000111000
0110000000110001001001100
0110000000110001001100100
0111000001110001001001100
0111100011110001001101000
0111111111110001010111000
0111111111110001100110000
0100010100010001001110000
0111111111110000001010000
0100011100010000011010000
0100010100011000010010000