0000000000000000000000000
0000000000000000000000000
0000000000000000000000000
0000000000000000000000000
0000000000000000000011100
0000000000000000000110000
0011111111111111111100000
0010010010010010000100000
0011111111111111111100000
0010010010010010001100000
0011111111111111111000000
0011010010010010011000000
0001111111111111111000000
0000001111110010010000000
0000000000011111110000000
0000000000000000110000000
0000000000000001100000000
0000011111111111100000000
0000111100000011110000000
0000111100000011110000000
0000011000000001100000000
0000000000000000000000000
0000000000000000000000000
0000000000000000000000000
0000000000000000000000000