0000000000000000000000011
0000001111000000000000111
0000011111100000000001111
0000111111110000000001111
0001111001111111111111111
0001111001111111111111111
0000110011001111001111110
0000000011000111000111100
0000000011110011110011100
0011100011110011110011100
0111111111111111111111110
1101111111111111111111111
1111111111111111111111101
1111111111111111111111101
0111111111111111111111011
0011111111111111111110111
0000000011111111111001111
0000000001101010000011110
0000000011000000000111100
0000000110000000001111100
0000000100000000011111100
0000000100000000111111111
0000000110101001111111111
0000000011111111011111111
0000000001111110011111111