0000111111011101111110000
0110011111011101111100110
0111001111011101111001110
0011100111011101110011100
1001110110001000110111001
1100110000111110000110011
1110001011111111101000111
1111100111001001110011111
1111101110001000111011111
1111001101011101011001111
0000011000111110001100000
1111011001110111001101111
1111111111100011111111111
1111011001110111001101111
0000011000111110001100000
1111001101011101011001111
1111101110001000111011111
1111100111001001110011111
1110001011111111101000111
1100110000111110000110011
1001110110001000110111001
0011100111011101110011100
0111001111011101111001110
0110011111011101111100110
0000111111001001111110000