0000000000000111110000000
0000000000001111111000000
0000110000011001001100000
0001111000111011101110000
0011111100111111111110000
0111111110111010101110000
1110011111010000000100000
1100001111111111111100000
1000000111111100011000000
1100000111111111111100000
0000000111111111111110000
0000000111111111111111000
0000000111111111111111100
0000000111111111111111110
0000001111111111110011111
0000011111111111110001111
0000111111111111100000111
0001111111111111100000011
0011111101101111000000011
0011111001001111000000011
0011110000001111000001011
0001111000000111100001111
0000111100000011110000000
0001111100000111110000000
0011110000001111000000000