0000000000111111111000000
0000000011111111111110000
0000000011111111111111000
0000000111111111111111100
0000000111111111111111100
0000001111111111111111110
0000001100000001111011110
0000001101101100010101110
0010001100101000000101110
0010001100000000000011111
0110001100010001100111111
1101000111000111001011111
1001100011111110001001111
1010111101111000010000011
0110111001110000111000011
0011111000100001111110001
0010111000000011111111001
0010001100000111111111100
0010000110001111110110010
1101100111001111110100010
1101100011100111100010100
1101100011111011100001000
1111100001111111000000000
1111100011110111110000000
0111001111110111111110000