0000000000000000000000000
0000000000000000000000000
0000000001110111110000000
0000000000111110000011100
0000000011111111100111000
0000000010101110001111000
0000111111111111011110000
0001111111111100011111100
0001111001111000011111000
0001100111011100011110000
0000011100001100111111100
0000011000011110111111000
0000001000100111111111000
0000000001111011111110000
0000000001000011111111000
0000000001111101111111000
0000000001000001111111000
0001000001111101111111100
0001100000110011111111100
0001111000011111110111100
0001110000001101110111000
0001011100011011101111000
0000000111111111111110000
0000000001111111111000000
0000000000000000000000000