0000000000000000111100000
0000000000000001110010000
0101100000000001110111111
0010000000000001111100001
0000000000011111111100110
0000000001111111111111100
0000000111111110111100000
0000001111101101111100000
0000001110011011111000000
0000011001110111111000000
0000011111001111110000000
0000011100011101100000000
0000110011111011100000001
0000111111110111100000011
0001111111101111000001111
0011111111110110000011111
0111110011110110001111111
1111110001111010111111110
1111100000101011111111000
1111100001101100111100000
1111000010000010100000000
1110001111111011100000000
0000111111110111000000000
0011111110001100000000000
1111110000000000000000000