0000011111111000000000000
0001110000001110000000000
0011000111110011000000000
0110001100111001000000000
0100001001101010100000000
0100001001101011100000001
0100000001110001100000001
0111100000000010100000001
0011111000000001100000011
0011000000000010100000111
0110100100000011100000111
1100100100000101000001111
1000001110000011000011111
1000001110000110000110110
1000011111000100000110111
1100011101000100001101111
0110011101111100011111011
0011111001111100111010011
0000111001111111110000111
0000001101111111110001111
0000000001101011100001001
0000000111001001100000011
0000011111000000110000111
1111111111000000010000011
1111111101000000011000111