0000000000000000000000000
0000000000000000000000000
0000000000000000000000000
0111111110011111111000000
0111111000110001111100000
0111100011100111100000000
0111001111111110011000110
0110011110011111000001100
0100111000001011000011100
0101100111000101100110100
0001101100100110100100100
0011001110100010110101100
0011001111100110011101000
0010000111000110111101000
0111100000001100111011000
0100011000011001111011000
0111001110000011101101100
0001100000001110000110100
0110111000111100000011100
0110011111100110000001110
0111100100111011000000000
0111110011001111100000000
0000000000000000000000000
0000000000000000000000000
0000000000000000000000000