0000000000000000000000000
0000000000000000000000000
0000000000000000000000000
0100000001111111000000010
0110000011001111100000110
0101100110000011110001110
0010111100000001110111100
0011000100000001111101100
0001110000111111110011000
0000011111111111111110000
0000000110001100110000000
0000011101101011011100000
0000001100001000011000000
0000001001110111001100000
0000011011000001101100000
0000011010011110101100000
0000011110110011110100000
0011101100001100001111100
0110011111000000011101110
0111101011100001110111010
0101111100111111001010100
0111000111001100101110110
0000000000000000000000000
0000000000000000000000000
0000000000000000000000000