0000000000000000000000000
0000000000000000000000000
0000000000000100000000000
0000000000001100000000000
0000000000011100000000000
0000001100011100000000000
0000000111011000000000000
0000000011101000000000000
0000111001100111110000000
0000011110101111111100000
0000001110011101110110000
0000000001111111111110000
0000000011111111101111000
0000000011110111111111000
0000000111111110111101000
0000000110111111111111000
0000000111111111101111000
0000000111111011111111000
0000000011011111111101000
0000000001111111011111000
0000000000111011111011000
0000000000011111111111000
0000000000000111101111000
0000000000000001111110000
0000000000000000000000000