0000000000000000000000000
0001111111000000011111000
0001111100000000000111000
0001111000000000000011000
0001111000000000000001000
0001111000000000110001000
0001110000000001111100000
0001100101100011111100000
0001110110000001111110000
0001100011100111111110000
0001000000000011101111000
0001000000000000110111000
0001111000000000101111000
0001100000000001101110000
0001011100000000011110000
0001100110000011111100000
0001000000000111111101000
0001000011111111111101000
0000001111111111111001000
0001111111110011111011000
0000011110000011111011000
0001000011100111100111000
0001111000111000011111000
0001111110000011111111000
0000000000000000000000000