0000111110000000011100111
0011110110000000100110101
0111001100000001100010011
0110011111001101000110000
1110110101101011111000000
1101110000101010000011100
1101100000101010000110110
1111101001100110000100010
0111101111001100010110110
0011010100011010000011100
0110111110111110000000000
1110111111110100011110010
1110110111110000110011000
1101111011100000100001000
1011111100011100100001000
0011111111111110110011010
0011111111111111011110000
0001111111111111000000000
0000000000111111100100111
0111111111011111100001001
0111111111011111100001011
0011000110111101001000110
0011111110110100111000000
0011000110000111110000000
1111111111111011101111111