0000000000000000000000000
0000000000000000000000000
0000000000000000000000000
0000001111111100000000000
0000000110011111000000000
0000000110000011101100000
0000001110000000101000000
0000001100000000101000000
0001101100000000101100000
0001111111000111101100000
0011111111110011111111000
0011100001111111111111100
0010011110001111111111100
0001110011101111111111110
0011000000110111110000110
0011001100110111001111010
0010011110010110011001100
0011001100010110110110110
0011000000110110110110110
0011100001110000111001110
0001111111100000011111100
0000011111000000001111000
0000000000000000000000000
0000000000000000000000000
0000000000000000000000000