0000111011100000000100000
1100101010100000001110000
1011001101100010011111000
0100000001000111011111000
0111011111001111111111000
0011111001101111110001000
0111110100100101010101000
1111110100100101010001010
1111100000010110111111101
1111001000110110000000001
1111001111000001111111110
1111100001001101100000111
1100111110010011101010111
1010001000011111111111111
1111001100000000000000000
1111100110000011100111111
1111100010000010100000000
1111111110000111100000000
0111111111111001100000000
1011111111111000010000000
1001111111111000010000000
1110111111111111110000000
1110100000000001100000000
1111110011000001100000000
1111111101000001100000000