0000000000000000000000000
0000000000000000000000000
0000000010000000100000000
0000000011000001100000000
0000000001100011000000000
0000000000111110000000000
0000000001100011000000000
0000000011010101100000000
0000000011111111100000000
0000000110001000110000000
0011101101101011011011100
0000111001101011001110000
0000010000001000000100000
0000010000001000000100000
0000010110001000110100000
0011110110001000110111100
0000010000001000000100000
0000010000001000000100000
0000010001101011000100000
0000111001101011001110000
0011101100001000011011100
0000000110001000110000000
0000000011111111100000000
0000000000000000000000000
0000000000000000000000000