0111111101111111000001110
1011000011000001110110111
1100110100000000011110000
0111101000000000111100111
1000001000000000011101110
1111010000000000011100011
0001011100000110001101100
1110010000100000001101111
1111011101001110000110001
0000010011001000001010110
1110010110000110001110111
0011010010000000000110001
1100010010000000011101110
0111101011100000001000111
1111001110011100101111000
0000011101110001101101111
1111110110000011001101111
1111110011000110001101111
1111110011111100011001111
0111110010110000011001110
1011110010000000110011101
0111110011000000110011110
1111110011000001100011111
1111111001100011100111111
1111111001100111000111111