0000000000000000011111110
0000000000000001111111100
0111111111111111111111100
1111111111101111111111000
1000000111111111111111000
1000000000011111011110000
1100000000001111011110000
0110000000000111010110000
0011000000000011110110000
0001100000000011110101000
0000110000111001111101000
0000011111100000011111100
0000000001110000000111110
1000000000011000000001110
1100000000111100000000111
1010000001111100001000011
1011000011111100000110001
0101100000001000000011111
0100111000011000000110001
0010001100110000001100000
0011000011000000011001000
0001100000000001110000100
0011000000000111001110101
0110000000111100000011111
1111111111100000001101110