0000111000000000001111100
0000101000110110011111110
0011101000110011100111110
0100001011110000111001110
1111111111111000101110010
0000000000000001110111110
0000000110000001000100100
0000001100000000100110100
0000011110000000110011100
0000111011000000011111000
0000110101110000001111100
0000000010101000011111100
0000000001001111111111110
0000010001001111111111110
1110111100111111101111110
1111111110000000011111111
1000000010000001110000001
1001100110000010000000001
1001011100000010000000011
1001000000000010111111111
1001000000000010001111110
1111000000000010001100010
0110000000000011111100010
0110000000001110010100010
1111111111110000011111111