0000000000000000011110000
0000011111111111111100000
0000111111100111111100000
0001111000011111111000000
0011110011111101111000000
0110001111111011011000000
1111111111110111011000000
0111111111001110011000000
0000000000011100011000000
0000000000111000011000000
0000000000110000011000000
0000000001100000011100000
0000000001100000001100000
0000000011000000001100000
0011111011000000001111100
0111111110000001111111110
1110011111000001110011111
1100111111000011100111111
1101111111000011101111111
1111111111000011111111111
1111111111000011111111111
1111111111000011111111111
1111111111000011111111111
0111111110000001111111110
0011111100000000001111100