0000000000000000000000011
1000000000000000000000110
1100000000000000000011100
0110000000000000000110000
0011000000000000001100000
0001100111111111111000000
0001111111111111111111000
0111111000000011101111110
1110001100000110000000111
1000000110001100000000001
1000000011000000000000001
1110000000000000000000111
1111111000000000001111111
1001111111111111111111001
1110000111111111110000111
1111111000000000001111111
1111111111111111111111111
1111111111111111111111111
1111111111111111111111111
1111111111111111111111111
1001111111111111111111001
1110000111111111110000111
0111111000000000001111110
0001111111111111111111000
0000000111111111110000000