0000000000000001111000000
0000000000110011111110000
0000000001110111111110000
0000000001110111111111000
0000000011101111111111000
0000000111101111111111000
0000000111101111111111000
0000001111110111111111000
0000111101110111111110000
0011111001110011111100000
0111111000100011111000000
0111110001101111111100000
0111111111111111111110000
0111111111111111111111100
0011111111111111111111110
0001111111111111111111110
0111011111111111111111111
1100000111111111111111111
1001001001111111111111111
1001111000111111111111111
1011111100111111111111111
1111111110111111111110111
0111111110111111111110111
0111111110111111111110111
1111111111111111111111111