0001111110000000000000000
0111111111110000000000000
1000011110011110000000000
1000000111001111100011110
0100000011111111111111100
1010000001111111111101000
1101000001111111111110100
1110110000110011111111100
1111001100011001111100110
1111100111000000111000010
1111110111111000000000010
1111110111000111000001011
1111110011100000110001111
1111111001100100001100111
1111111100001110000100111
1111111111111110000010111
1111111111111000000011110
1111111111110011100011110
1111111111111001110111100
1111111111111100111111001
1111111111111110011100011
1111111111111110011100111
1111111111111100111001111
1111111111111001110011111
1111111111111100001111111