0000000000011110000000000
0000000000111110000000000
0000000000111111110000000
0000000000111111111000000
0000000000011111111000000
0000000000011111110000000
0000000000011111110000000
0000000000111111110000000
0000001111111111100000000
0000011111110000000011100
0000111111110000000111110
0001111111110000001111110
0001111111110001101111111
0011111111110000101111111
0011111111110001110111101
0111111111110011111111111
1111111001111111011111110
1111111000111110001111000
1111111000011100001111100
1111111000111111111111111
1111111100011111111111110
1111111100011111111111110
1111111110011111111111110
1111111110001111111111100
1111111111111111111111111