0000000000000000000011111
0000000011110000001111010
0001100111111000111111100
1110110110011101111110100
0001011110001101111111000
0000111100001101111101000
0001011100011101111110000
0001111100111000111100000
0011011001110000011100000
0110110011100000001110000
0011100111111000011111000
0001000111111100111111100
0000000011111111111111110
0000000001111111111111111
0000000000000011110001111
0000000011111000000000111
0000001111111110000000111
0000011110011111000000111
0000111000000111100001111
0100110000000011110011111
0100111111111001111111110
0110011111111110111111100
0010000000000111011111000
0011001111000011000000000
0001111001111110000000000