0111111100000000000000000
1111100110000000000000000
1111110010000000000000000
1111110010000000000000000
1111110010000001111100000
1111100110000111111111000
0111111100001111111111100
0010001000011111111111110
0011111000111111111111111
0010001000110000001111111
0011111000100000000111111
0001110000110001100001111
0000000001011010110001111
0001110001011010110000111
0001010001011010110001111
0001010001001010010001111
0001010000110011100001111
0001010001001100000011110
1111111101000000000011111
1010100101001111110001001
1010110101001111100001101
1111100101100111000000011
0100001100110000000011110
0110001000011111110010000
0010001000000010000010000