0000111111110000000000110
0001111111111000000000100
0001111111111100000001100
0011111110011100000001100
0011111100111100000000000
0011101000001100001110000
0111100001010000001011000
0101100000010000001000000
1110110000110000011000000
1111110011100000011000000
1101100010000000000001111
1100100111100000000001111
1001110001110000000001111
0001110000111000001111111
0011111000111111111000110
0111111100111111000010111
0111101111111111001011100
0111110111111111111111111
0111111011100000011111000
0111111100000000111111111
0111111111111111100010001
0110111111110000001011111
0111011111110001001100011
0011101111111111011111111
0011110000000111111000111