0011111000111111111100011
0000001110100000001101110
0000000000100000001100000
0000011100100000001100000
0000000000111111111101100
0000011100000111110000111
0000110111100111110000000
0000100000111111110111100
0001100000000000111100100
0001111000111110000111110
0001111111100001100000010
0111111111011110110000010
1000011110101111011111110
1000011110100111011111100
1111111110100111011111111
1000011110110111011111001
1000011111011110110000001
1111111111100001110001111
1000011111111111111110001
1000001111111111100000011
0111111000011111100011110
0111111000000000111100010
0111111100000000100001110
0011111100000001111111000
0011111110000001111111000