0000110110011111111100000
0000010010110011000110000
0000010010100110000010000
0000011111101100000110000
0000111111111000001100000
0000110001110000011000000
0000101010111111111100000
0000100000111110101110000
0000110101111110101011000
0000011111011111101011100
0000000000010111011011111
0000000000110101110111100
0000000000001101011111000
0000000000000011000000000
0000000001010100000000000
0000000001010100000000000
0111100111111111001111000
1100111100000001111001100
1000011000000000100000100
1000001000000000100000101
1100001100010001100001101
0110000110111011000011011
1011111111111111111110111
1100001111111111100001110
1111110000010000011111100