0010000111111110000001000
1010101100000011000101010
0010011011111101100011100
1101010011111100101110111
0010001000000001100011100
1010011111111111000101010
0010111111111111000000000
0010111100111111101111100
0000111000011111111000010
0000110100101111110111011
0000010100100111110100001
0000010000000011110101101
1110010100010111111010101
1010010011110111110101101
1110001000001111110111001
0100001111110111110100001
0100000100000111110101001
1111001000001011100101010
1000101000011011100101010
1000011111110001111001100
1101000000000001001000100
0111000000001001001101000
0101111111111001000101000
0100001000000001000111000
0100011000000001000000000