0000000000000000000000000
0000000000000000000000000
0000000000000000000000000
0000001000000000001110000
0000011100000000001110000
0000111110000000001110000
0000111110000000000100000
0000001000000000011111000
0000111110000000111111100
0001110111000001111111110
0011111111100011011111010
0110110110100010011111010
0100011100110110001110010
0100111110010100011111010
0100111110011100011111010
0001111111000000011111000
0001111111000000011011000
0001111111000000011011000
0011111111100000011011000
0011111111100000011011000
0000010100000000011011000
0000010100000000001010000
0000110110000000111011100
0000000000000000000000000
0000000000000000000000000