1111111111111111111111111
1111111100000111111111111
1111111000000111111111111
1111111000000111111111111
0000011111111111111111111
0000010000000111111111111
0000010010100111111111111
0000011001001111111111111
0000011100011111111111111
1101110000000111111111111
1101000000000001111111111
1100000011100000111111111
1000100010100100011101111
1001100011100010011101111
1101100000000010011000111
1101110011100111110010011
1101100010100011111010111
1101000011100001110010011
1101000000000000100010001
1101000011100000111010111
1101000010100000110010011
1101000011100000100010001
1101000000000001000010000
1101100000000011111101111
1101110000000111111101111