0001111100000000000000000
0011111111000010001000100
0111111111101010001000101
1111101111101010001000101
1111000011101011001001101
1110100101001001001001001
1010100101001101100011011
1100000001000100100010010
0100111101000000000000000
0110100001000001111111000
0011000011000011111111100
0001111110000111010101110
0011100010000111011101110
0111111111100000111110011
1110000000110001100011001
1100100010011011101011101
1000100011001011100011101
1111110001101011111111111
0010010111001111111111111
0010010101001010000000100
1101110111111011111111100
1111111111111111111111100
0000000000000110000000100
1111111111111111111111100
0000000000001011111111100