0000001110000000000000000
0111110111011000000000000
1111110011101100000000000
0011111011101110100000000
0111111011101110110000000
1111111111111110011000000
1100111000001111111000000
1000110000000111111000000
0001111111000111011100000
0001001001100111011100001
0011000000100111011110011
0010110110100111011010111
0010110110100111011011111
0111111111110111011011111
1100000000000111011011100
1100000000001111011011110
1110000000001110110010111
1011000011001101100110011
1001111110011011001100011
1000111100010010011100011
1100000000000001111000000
0111111111111111100000000
0001111111111111111111000
0111100000000110001110000
1110000000000011111100000