1111111111100011111111111
1111111100011111000000000
1100011111110000000111110
1010101111111111111100011
1101011111000010000111000
1010101110000010000001110
1101011100000111100001011
1010101000001111110001101
1101011000011111111000101
1111110000111111111100001
1111110001111111111110000
1111110011000000000011000
1111100111111111111111100
1111100001100011000110000
1111100001100011000110000
1111100001110011001110000
1111100001111111111100000
1111110000110011001100000
1000110000110011001100000
0101011000111011011100000
1010111001111111111110000
0101011100011111111000000
1010111110001111110000000
0101011111100011000000000
1010111111111000000000000