1111100000000000000100000
1111000000000000001100000
1110000011111110011100000
1100001111111111111100000
1000011111111111111100000
0000111111111111111110000
0001111111111111111111000
0001111111111111111111100
0011111111111111111111110
0111111011111111111111110
0111000001111111111111111
1110000000111111111111111
1110000000011111111111111
1100000000000111111111111
1100000000000011111111111
1100000000000111111110111
1111110000001111001111110
1111111000000000000011110
1101111100000000000001110
1110111110010001000101110
1110000001110111011110111
1110111111111111111111011
1101111111110000111111100
1011110001111111110001111
0111111111111111111111111