0010001101111111000000010
0010011000011111111000111
0110110001000111111110010
0110110111000011111111000
1101101110000001111111100
1111101100001100111111110
1111111100111000011111110
1111111011100001001111111
1110011111100011101111111
1101001111001101001100111
1101100110011000001110111
1100000111110000011111111
1100000111100000001111111
1100000111001111001101111
0000000111111100000011111
1110001111110000001111111
1100001110000010001111111
0000011111000111011111111
0001111011100010011111110
1111111001110000111111110
0111011100011101111111100
0011101110000011111111000
1001100011100111111110010
1101100000001111111000111
1000100001111111100000010