0000000000000000000000000
0000001111011111111100000
0000111111001111111111000
0001111100000111111111100
0011000000010011111111110
0111100000110011111111110
1111110001000011000111111
1100110011010010011011111
1110010000000110110001111
1011001000001100110101111
1011101111011101100000111
1001101111011101111011111
1001100000000001100000111
1100111100000011111011111
1100011110000011100000111
1110001110000001111011111
1111001100000000110001111
1111100100000000111011111
1111100100000000110001111
0111100100000000100100110
0011110110000001101110110
0001110010000001111111100
0000111000010000011111000
0000001111111111111100000
0000000000000000000000000