1011100000000110000000000
1110011000000011000000000
1100110011110001100000000
1001100111111000110000000
1001000111110000010000000
1011110111111001110010000
1110000111110011100011000
1011000011000111100111100
1001100111111111001111110
1000100111111110011111111
1000000111111100111110111
1000000111110001111110011
1000000111111000111110000
1000000111111111101110000
1000000011111110000010000
1000000001111111100000000
0000000011111011110000000
0000001111111101110000000
0000111000011100111000000
0011100000011100111100000
1110000000111000000000000
1000000001110000000000000
0000000000110000000000000
0000000000011000000000000
1111111111111111111111111