1111110000011100001111111
1110001110111110000011111
1100011111111111000001111
1100111111111111000000111
1000111111111111000000111
1001111111011111110000011
1001111110001111111000011
1001111000000001111100001
1011111001010101111100001
1011111100111011111100001
1010111110111011111100001
1000111110010011111100001
1000111110111011111100001
1000011111101111111100001
1000011111011111111100001
1000011111110111111100001
1000011110001111111100001
1000111111111011111100001
1000111111000111111000001
1000111111101111111000001
1000111111111111111000001
1000011111111111111000001
1000101111111111110100001
0011111111111111111111000
1111111111111111111111111