0000000000000000000000000
0001111100111111111000000
0001111100011111101100000
0001111100011111000110000
0011111110001110000011000
0010010010011100000001000
0010111010010100000001000
0010010010011110000001000
0110111011010100000011000
0100010001011110000011000
0100111001010100000111000
0100010001011110001111100
0100111001010100001001100
0100010001011110001000110
0100010001010100001000011
0100010001010100001000000
0101111101111100001000000
0111000111101000011100000
0110000011001100011100000
0110000011000110111100000
0111000111100011111100000
0111111111111111111000000
0111111110111111110000000
0011111100011111000000000
0000000000000000000000000