0000000000000000000000000
0000000000000000000000000
0000000000000000000000000
0000000000000000000000000
0011111111110111111111100
0011111111110111111111100
0011111100010100011111100
0010111011100011101110100
0011000111110111110001100
0011101111110111111011100
0011101111110111111011100
0011101111110111111011100
0011101111110111111011100
0011010111110111110101100
0011010111110111110101100
0011010111110111110101100
0010111011110111101110100
0010111011100011101110100
0010111011110111101110100
0000000001110111000000000
0010000011100011100000100
0011111110000000111111100
0000000000000000000000000
0000000000000000000000000
0000000000000000000000000