0000000000000000000000000
0000000001111000000000000
0000000111111100000000000
0000000111111110000000000
0000001111111110000000000
0010001111111110000000000
0001111011111111000000000
0001111111111111000001100
0000011110111111000011110
0000001110111111000011110
0000001110011111000001110
0000001111011110000011000
0000000111100111111100000
0000001111111111111000000
0000001111111111111000000
0000001111111101111000000
0000000110111101111110000
0000000010111101101110000
0000000010111000110010000
0000000111010000010111000
0000001111010000111111000
0000001111111001111111000
0000001111111001111111000
0000011111111000111110000
0000000001110000000000000