0111111101100000111111111
0111111011000000001111111
0111111010000111111111111
0111110010001110011011111
0111100010011100001100111
0111000111001001100110011
0111000101001011110110011
0111000101101001000100001
0111100100110101100100001
0111100100011010110100001
0101110100001111011110001
0101101110001011111110001
0001100010000100011000000
0000110001000110000000000
0010110001000011000000001
0010011000100001110000111
0001001100110000011111111
0001100111011111100001111
0100110111111100000111011
0100010011111111111110111
0110000011110000000000111
0111000111000111111001111
0111100110000000000011111
0111110110000000001111111
0111111101111111111111111