1111111111111111000000000
1111111111111111100000000
1111111111111111111110000
1111111111111111111111110
1111111111111111111111111
1111111111100111111111111
1111111101000011111111111
1111111000000001111111111
1100111000000001111111111
1010100000111111111111110
1010100000011011111111100
1100100000000011111110000
1110110000000011111100000
1110000000000011111000000
1110000000001011100000000
1111000000000110000000000
1111000000111100000000010
0111100000000100000000110
0001111000011100000001100
0000011100001000000011000
1110000110011000000110000
0011000011110000001100000
0001111100000000011110000
0000000111111000111011000
0000000111111101110111000