0000000000000000000000000
0000000000000000000000000
0000000000000000000000000
0000000000000000000000000
0000011110000000000000000
0000111111000000000000000
0000111111000000000011000
0000010111100000000111100
0010111111100000000111100
0001111111111100000011100
0000000111111101110110000
0000001111111111111100000
0000001111111111111100000
0000001111111111111000000
0000001111111110111000000
0000000111111001111000000
0000000001110001110000000
0000000000110000111000000
0000000000011000001100000
0000000000011000011100000
0000000000110000111000000
0000000000000000000000000
0000000000000000000000000
0000000000000000000000000
0000000000000000000000000