0000000000000000000000000
0001110000000000001100000
0110111000000110011110000
1111111100001110111110000
1111110000011111111111000
0011110000111111111111000
0001111001111111111111100
0001111011111011111111100
0001111111110111111111110
0000111111101111011011110
0000111110011110111011110
0000011111111111111111110
0000011111111111101111010
0000001111111000010111010
0000000011110000010110010
0000000101100000010110000
0000000101100000011010000
0000000100100000001011000
0000001100110000001011000
0000001000110000001001000
0000011000100000001001000
0000010000100000011001000
1100110001100000110011000
1111111011001111100110000
1111111111111111111111111