0000000000000000000000000
0000000000000000000000000
0000111111111000111111000
0001111111111101111111100
0001111111100101111111110
0001111111010100101111110
0001111110000010110101110
0001111100010101000011110
0000111110001000100011100
0000111110111000011010000
0000011100100000001001000
0001101000111000011001000
0011101101101100100000100
0111110111011111110100100
0111111001110010000100100
0111111111000011111011100
0111111111000110111111110
0111111100011000111110010
0111011000110011111001000
0100000001110001001100010
0100000011111001100111100
0110000111110001110100000
0011111111100011100010000
0000111111111111001110000
0000000000000000000000000