0000000000000000000000000
0000000000000000000000000
0000001111110000001101100
0000011111111100000010110
0000111111111000001011110
0000011101111111000001100
0000011011111110000000010
0000011011111011100010010
0000010010111100000000000
0000000110111110000000000
0000000101111011100000000
0000111101111100110110000
0001101111111111111111000
0011000111111111111011100
0010011111000111011011100
0000110000000010111011110
0000100000000010110001110
0000010000001111011000000
0010000000001000011000000
0011000000001000011000000
0011000000001000110000000
0011001000000101100010000
0001101111000001000101110
0011110111111111111011100
0000000000000000000000000