0000000011101111111100000
0000001111110111110110000
0000011011111101100111000
0000010101111110110111100
0000001111011111011000100
0000001001010111101101100
0000011110101011110111100
0000101010010011111001110
0001000001010101111110010
0000100000001101011111110
0000100000110110101111110
0000010001011010101111100
0000110001111010101010000
0110100000110010110101100
0111100000000101010110110
0011111100001101010101010
0111110111001010101001010
1111111101100101010101101
1111111100100011010110110
1111111100010001011011011
0111111100110010100010111
0011111101011010100110111
0001111101110101001101111
0000111101101000011011110
0000111101111000110111100