0001110000000000000111000
0011111000011100001101111
0011111000110111101111000
0011111000111100001001000
0001110000100100011000100
1100000000100111110000100
1111000001100011111100100
1111111111000011111001100
0111111111100011110011000
0001111111100110111110000
0000111100001100010100000
0000001111110011111111000
0000000010100111000001110
0000001111111111111000011
0000111000000011111110001
0001100011100001111111001
0011111111111000110111001
0111111110111100111001111
1111101111011100100000000
1111110111001111000000011
0000000000000000001111100
1111111000000000000001111
1111100001111100000110111
1001111111110001111111100
1110011111111110011100011