1111111111111111111111111
1100001000000000000100001
1001110000000000000011100
1001110000000000000011100
1000100000000000000001000
1100000000000000000000001
1100000000000000000000001
1110000001100000110000000
1110000001100010110000000
1110000000000010000000000
1110000000000011000000000
1110000000000011000000000
1110000000000011100000000
1110000000111111100000000
1110000000101101110000000
1110000000111111110000000
1111000000011111110000000
1111000000011111110000000
1111100000000111100000000
1111111000000000000000000
1111111111000000000000000
1111111111100000000000000
1111111111110000000000000
1111111111111000000000000
1111111111111100000000000