0000000000000001111100000
0000000000000111110111110
0000000000000001111111110
0000000000000001111111100
0000000000000001111100000
0000000000000001111000000
0000000000000001111000000
0000000000000001111000000
0000000000000001111100000
0000000000000011111100000
0000000000000111101100000
0001100000011111110100111
0011110000111111111011101
0111111001111111111011001
0111100111111111111110001
0111101111111111111100001
0111001111111111111100011
0111001111011111101110010
0011000111110100000111000
0011000011110100000001000
0010000001101000000011000
0010000011010000001110000
0000000111000000000100000
0000000000111101000000000
0000000000000110100000000