0111010001100000000000000
0111000001010000000000000
1010100001011100000000111
0000000011111110000011101
0010011110011110000110010
0000011001000011001100110
0000001110000111001000100
0000000011101110011011100
0000111100011100011111100
0001111110111100011111100
0001110111111110011111110
0000100011111110001111110
0000100001111111001111111
0000100001001111100111111
0000100000100111110011111
0000100000010011110011111
0000100001110111111111110
0111110011101111111111100
1101100011011111111100000
0011100011011111110011100
0101111001101111000100110
1011011111110111111011011
1011010111111111111011011
0100110000000011100100110
0011100000001111000011100