1111111111111111110011111
1111100111000001101101111
1111011010000000001101111
1111011000000000000011111
1111100000000000001111111
1111111001100011001111111
1111111000000000001111111
1111111000100010011111111
1111111000000000011111111
1111111100011100011111111
1111111110011100111111111
1111111111001001111111111
1111111100111110011111111
1111111001000001001111111
1111110011000001100111111
1111110010000000110111111
1111100010000000010011111
1111100011000000011011111
1001100001100000001010001
0000110000110000001100100
0110011000010000011101110
0111001100010001100101110
0011101010011111000101110
1011101001111111100100110
1001101011111111110010110