0000000000000000000000000
1110000000000000000000000
1111000000000000000000000
1111100000000111111100000
1111110000000111000111000
1111111000000000000001000
1111011100000011110001100
1111001110000011011000100
1111001011000000001000100
1111001001000000001000100
1111001001110000001000100
1111111001111000001000100
1111111111101000001000100
1111011111101000001000100
1111001001111000011000100
1111001001101111101100100
1111001001011101110110100
1111001010111111111011100
1111001101111101111101110
1111011011111000111110111
1111110111111111111111011
1111101111111000111111101
1111011111110000011111110
1110111111110000011111111
1101111111100000001111111