0000111100001110000101111
0001111110011111001110111
0001011110011111011111010
0011111110011111111111101
1111111110001110100000101
0000011100000100101010101
0000111100000100101010101
0001111000001011100000110
0011110111110000111111100
0011111111111100000000000
0011111100001111000000000
0011111111110001100000000
1101111111001110111011111
0000111111110011011000000
0000011111111100101110000
0000001111111111111100000
0000000011111111100000001
0000000000111110000000111
0000000000001000000001111
0000000000111110000011111
0000000011111100001111100
0000000000110000111111111
0000000000000011111001111
0000000000001111111110001
0000000001111100001111111