0000000000000011110000000
0000000111101111111000000
0000011111111111111100000
0001111111111110001110000
0011101111011100110110000
0111011100111101101111100
0110111011111101110111100
0001111110111110001111100
0001111000111111111111000
0011110000111111111111000
0011000000011111111100000
0000000000000111110000000
0000000000001111111100110
0000000000001111111111110
0000000000001111111111110
0000000000011111111111000
0000000000111111101111100
0000000000111111100001100
0000000001111111111000000
0000001001111111111100000
0000001111111111111101100
0000001111111111111111100
0000001111111111111111100
0000000111111111111111100
0000000001111111111111000