0000000000000000000000000
0000000000000000000000000
0000000000000000000000000
0000000000000000000000000
0000101000000000000000000
0000011000000000000000000
0000111100000000000000000
0001011110000000000000000
0001111110000000000000000
0011101111000000000000000
0001001111100001111100000
0000001111111111111110000
0000001111111111111111100
0000001111111111111110110
0000000111111111111110110
0000011111111111011100110
0001111111111100011110110
0001100011000000010110010
0000100011000001110010000
0000110010000011000010000
0000010010000000000010000
0000000100000000000100000
0000000000000000000000000
0000000000000000000000000
0000000000000000000000000