1111000111001000100010001
0111100011101110101110001
0111111001110111111100011
0011111100010111111101111
1111111111010011111011111
0011111101110001110111110
0111111000010000100111110
0111100000011000101111100
1110000000001100111110000
0001111111000110100000111
0111000001110010100001110
1100000000011010100111110
1001111000001010101111100
1011001101111010111111111
1010000101001010101111100
1010100101101011100111110
1011100100001010000001110
1100001101011011111100111
0110011011010010011111000
0011110111010110001111100
0000000110011111100111110
0000000100110000110111110
0000000111100110010011111
0001111100000100110000111
1111000000000111100000001