0000000000000000000000000
0000000000000000000000000
0000011100000001000000000
0000010000000011100000000
0000011100000111110000000
0000000000000011100000000
0001010111001111111000000
0001110100011111111100000
0001010100000111110000000
0000000000111111111110000
0000001001111111111111000
0000011100011111111100000
0000011100111111111111100
0001101011011111111111110
0011110111100011100000000
0011101011100011100000000
0011011101100011100000000
0011011101100000000000000
0011011101100000000000000
0001011101000000000000000
0000011100000000000000000
0000011100000000000000000
0000001000000000000000000
0000000000000000000000000
0000000000000000000000000