1111111011010000010111111
1110110111110000011111111
1110010111011000110111111
0001001111111111111111111
1100000011110101011110001
1000001101111111111101110
1110100111111111111011111
1110111111111000111101111
1110111111110111011101100
1101111111001111100011110
1101111110111111110011110
0010000001111111111111100
0010000001111111111111000
0100000011111111111110000
0100000111111111111000000
1100001101111111111000000
1100010011111000111000000
1100000110110000011000000
1100000100110000111000000
1100001100100000101000000
1110001001100000101000000
0000001000100001001000000
0000001000110001001100000
0000001000010001000100000
1111101100001001000110111