0000000000000000000000000
0000000000000000000000000
0000110000000000010000000
0000111000000101110000000
0000001000001111100000000
0000001000011111110000000
0000001000011101100000000
0000001000011011001100000
0000000100110110111011100
0000000110110111111111110
0000000011101111001111100
0000011101010000111111000
0001111110101111111111100
0011111101010011101110000
0111110011011101110000000
0101101111101110111100000
0011111101101111011110000
0011111011101011011110000
0011010111111011101111000
0010000110111101111110000
0000000101111101111110000
0000000101111100101011000
0000000000110100000000000
0000000000100000000000000
0000000000000000000000000