0000000000000000000000000
0000000000000000000011110
0000000000000000001110000
0000000000000000011111100
0000000000000000111000000
0000000000000001111111000
0000000000100001100000000
0000000000110001111110000
0000000000111101110000000
0000000001100110111110000
0000001111100110011100000
0000000110011110110100000
0000000010010110111000000
0000000011111001111100000
0000000001111011111100000
0000011110000111111100000
0000111111011111111100000
0001110111111111111011110
0011110101101111110101000
0011010101110111101111100
0111010101000000010110000
0101010000000000011101000
0101000000000000010100000
0100000000000000010000000
0000000000000000000000000