0000000000000000000000000
0000000000000000000000000
0000000000011111000000000
0000000001111111100000000
0000000001111111110000000
0000000011111111110000000
0000000011111111110000000
0000000001111111100000000
0000000001100011000000000
0000000000011100000000000
0000000000101110111100000
0000001110101110111110000
0000011110101110111111000
0000111111011101111111000
0000111111100011111111000
0000111111110011111110000
0000111111110001111110000
0000011111100100111100000
0000001111001100000000000
0000000000001100000000000
0000000000001100000000000
0000000001111111100000000
0000000011111111110000000
0000000011111111110000000
0000000000000000000000000