0000000000000000000000000
0000000000011111110000000
0000000000111111111000000
0000000000111111111110000
0000000001111111100110000
0000000101111111000011000
0000001101011111001111000
0000001110011111111011100
0000001111011111110000000
0000011110111111111100000
0000110111110111111111000
0000110001100000111111100
0001111000111111001111110
0001000001111111110110110
0000011111111111111011010
0011111001111100111011010
0010111111110001111111100
0001101111100011111111100
0000000111101011111111010
0000000001101111111010010
0000000000101111111110110
0000000000110111111001100
0000000000011011110111000
0000000001111111111100000
0000000011111111100000000