0000000000000000000000000
0000000000000000000000000
0011111000001111001111100
0011111100111111100111100
0011111100100011110011100
0011111101100001111001100
0011111101100100111001100
0011111100111000011101100
0011111110000000011101100
0011111110000110011101100
0010000000110110111100000
0000111011110011011101000
0001111111011111101011000
0001001100111101111001000
0000010011010110110110000
0011000111101011100011000
0011110111101110111011000
0011110011101100011010000
0011111000000110011000100
0011111100110110010011100
0011111101111110000111100
0011111101001110111111100
0011111100011100111111100
0000000000000000000000000
0000000000000000000000000