0000000000111000000000000
0000000011111110000000000
0000000111111111000000000
0000001111111111100000000
0000001111001001100000000
0000001111011011100000000
0111001111001001100000000
1111100111111111000110000
1101100111111111001111000
1101110011011010011111100
0100111111100110011001100
0000011111111111111011000
0000000111111111110000011
0000111111111110001100001
0011111011111111101110011
0111110111111001110111111
0111000110110110111011110
0111000110110111011000000
0011100110111011011100000
0001101110011011001110100
0000101100111011000111100
0001101101110011100011000
0000001101000001110000000
0000011101100000110100000
0000111000000000011100000