0000000001111000000000000
0000001111111100000000000
1111111111011110000000000
0111110011111110000000000
0000000111111100000000000
0011111101111000000000000
0011111011110000000000000
0001110111100000000000000
0000001111000000000000000
0000001110011110000000000
0000011111111111100000000
0000111111111111111000000
0001111110001111111110000
0001111110111111111111001
0001111110111111111111111
0000111110001111110001111
0000011111100000000111111
0000001111111111111111100
0000000011111111111100000
0000000000010001000000000
0000000000010001000000000
0000000000010111000000000
0000000001110111100000000
0000000011110000000000000
0000000011100000000000000