0000110000010000011000000
0000110000010000011000000
0000010000010000010000000
0000010000000000000000000
0000000000000011111000011
0000000000011111111100111
0000000011111111111110000
1111001111111111111010000
0000011111111101110110000
0000111111110000111100000
0000101111100000001000000
0000110011100011111100000
0001011111001110001100000
0011000100111100100110000
0010001111111101010110000
0110001111011101010111000
0100011111011100100111000
0100011111011110001111001
0100011111011111111111001
0110011111011111111111001
0110001011111111110010011
0111000000111100000000111
0011110000010000000001111
0011111110000000001111111
0001111111111111111111111