0011111110000000111100011
0111001111000001100010011
0110110111111111011010111
0110110000000000011010111
0110110000000000011010111
0110000111000111000010111
0111000111000111000110111
0011110010110010011110111
0001110000111000011111011
0001110000111000010111011
0010011000000000110111111
0011001111000111100011111
0001100001111100000001111
0011110000000000000000111
0110010000000000000000111
1110010000000011111000111
1110011100011111100000111
1111000111111000000000111
1111000010111100000000111
0011110010011100000000111
0001111100011000000000111
0000111111001000000001111
0000001111111000000011111
0000000111100000001111111
0000000011111111111111110