0000000000111111110000000
0000001111100000111000000
1111111111000011111111000
0111111110100111111010110
1111101111000111110001111
0000011100110111111111101
0000111111100111111110000
0001111110000111111111000
0000011000001111111111100
0001110011001111111111110
0011110111011111111111111
0011101110010111111111111
0011111110110011111111111
0001111101100011011111111
0011111101100000111111110
0111011111000001111111110
0110111111000001111111100
0101111110000001101111100
0001111110000001011111100
0011101110000000011111110
0011011100000000011011110
0011011100000000011011111
0000011100000000001011011
0000011100000000000011100
0000001100000000000001110