0000000000000000000000000
0000000000000000000000000
0000000000000000000000000
0000000000001101100000000
0000000000010111010000000
0000000000011111110000000
0000000000001111100000000
0000000000000010000000000
0000000000000010000000000
0000000000000010000000000
0000011101110111100000000
0000111011110111111000000
0000111011111011111100000
0000110111111011111100000
0000001111111011111110000
0011001101110111111110000
0011111111111111111110000
0000111111111111111111100
0000011111111111111100110
0000000011111111110000110
0000000000110011000011110
0000000000000000111111000
0000000000000000100000000
0000000000000000000000000
0000000000000000000000000