0000000000000000000000000
0000000000000000000000000
0000111111101111011110000
0000111111011101101110000
0000111111011001101110000
0000111111011101101110000
0000111100011101100110000
0000110001101111011010000
0000010110011100001100000
0000100100111000000100000
0000111000000000100110000
0000101001001011100010000
0000100011011010100010000
0000100011111000100010000
0000110110001101100010000
0000010101010101000010000
0000010100000100000110000
0000011010001100000100000
0000001001111000010100000
0000001100000011110100000
0000000110111010011100000
0000000011101110011000000
0000000011001100000000000
0000000000000000000000000
0000000000000000000000000