0001110111111100000000000
0110111111111111100000000
1111111111111111111000000
1011111111111111111100000
0100111100011111111110000
1011111001100111111111000
0111100010110011100011000
1100000010010010000100100
1001110001110001001001110
0011000000000000000111110
1101110000000000011111111
0011111100000000111111111
0111000010000000111111111
1110000000001110111111111
1110100000011110111111111
1110100000111111011111111
1010000000111111100111111
0111010001111111111011111
1011011001111111111101111
1111100101111111111001111
0111111000111111110001110
0111111110011111000001110
0010111111110000000001100
0101111111111000000011000
0011011111111000000110000