0000000000000000000000000
0000000000000000000000000
0000000000000000000000000
0001000000000111100001100
0000000000011110000111000
0000000001111100001110000
0001000111111110001010000
0000011100101110011010000
0010111110010111010110000
0000111111010011110100000
0001110111001011111100000
0011101011001011111000000
0011100111001011110100000
0001111111010110110100000
0011111110010100011010000
0001111110101100011010000
0000111101111000001110000
0000001111111000000111000
0000000111011100000000000
0000000001100110000000000
0000000000111111000000000
0000000000000111100000000
0000000000000000000000000
0000000000000000000000000
0000000000000000000000000