0000000000011000000001100
0011100000010100000010100
0111110000010110000110100
1000001000010111000110100
1000001000011111111111100
1111111000011000000001100
1111110000110000000000110
1000010000100111000011010
1000110001001111100111101
1111100001001110100101111
1111100001011111111111111
1000100011011100011110110
1000100101111100001101100
1111101100000110001101000
1111111000000011011110000
1000010000000001111100000
1000111000000000000100010
1111111000000000000110011
0111101100000000000011111
0110001100000000110001110
0010011110000000011111000
0011111011100000001000000
0001110011010000001000000
0000110011000000001110000
0000011111111111111110000