0000000000000000000000000
0000011110000000000000000
0000111111000000000000000
0001111011100000000000000
0001011001100000000000000
0001111001100000000000000
0001110001100000000000000
0000110001100000000000000
0000100011000000000000000
0000000011000000000000000
0000000110000000000000000
0000001110000000000000000
0000011100000000000000000
0000011000000000000000000
0000111000000000000000000
0000110001111111100000000
0000110111111111111000100
0000111111111111111111100
0000111111100000111111100
0000111111000000011111000
0000111110000000011111000
0000011111000000111111000
0000011111111111111110000
0000001111111111111110000
0000000111111111111000000