0000000000000000000000000
0000000010000000000000111
0000000010000000000011111
0000000101100000001111111
0000001011100000011111110
0000001011110000000011000
0000010000010000101010000
0000010111110000101000000
0000010000010000101000000
0000010111111001111111111
0000010000001000000000000
0000010111111011111111111
0000000000001010000000001
0111111111101010111011101
0000000000101010000000001
0110110110101011111011101
0000000000100000001000001
0110110110101111101011101
0000000000100000101000001
0110110110101010101010101
0000000000100000101000001
0110110110101010101010101
0000000000100000101000001
0110110110101010101010101
0000000000100000101000001