0000000011101110110110110
0011100011101110110110110
0111110111111111111111111
1111010000000000000000000
1011111000000010001000100
1011110000000111011101110
1101100001110111011101110
1101111110000111011101110
0101111100111111111111111
1001111000000000000000000
0001111110000000110110110
0001110001100000110110110
0011111000011001111111111
0011111000001100000000000
0111111100000111111111111
0111111100000011010101011
1111111110000010101010101
1111111110000011010101011
1111111110000010101010110
1111111110000011111111110
0011011000000010000000000
0011011000000010000000000
0110001000000011111111110
1100001000000010100000101
1000001100000001000000010