0000000110000000000000000
0000000011000000000000000
0000000111000000000000000
0000111110000000000000000
0011111000000000000000000
0111000000000000000001110
1110000000000000000111100
1100001111100000001111100
1110111111111000011111110
1111111111111100011111011
1111111111111110111111111
0111111111111111111111111
0111111111111111111111110
0111111111111111111110000
1111111111111111111100000
1111111100111111111100000
1111110000001111111000000
1111100000000111111000000
1111000000000011111000000
0110000000000001111000000
0110000000000000111100000
0110000000000000011100000
0111000000000000001110000
0011110000000000000111100
0001110000000000000011100