0000000000000000000000000
0000000000000000000000000
0000000000000000001111100
0000000000000000111111110
0000000000000011111111111
0000000000001111111111111
0000000000111111111111111
0000000011111111111111111
0000001111111111111111111
0000011111111111111111110
0000111111111111111111100
0001100001111111111111000
0011000000111111111110000
0110111110011111111100000
1101111111001111111000000
1001111111100111110000000
1011100001100111100000000
1011100001100111000000000
1011101001100110000000000
1101101111001100000000000
0111100110011000000000000
0011110000110000000000000
0001111101100000000000000
0000111111000000000000000
0000000000000000000000000