0000000000000000000000000
0000000000000000000000000
0000000000000000010000000
0000000000000000110000000
0000000100000001110000000
0000000110000001111000000
0000001111000011111000000
0000001111110011111000000
0000000111111001111000000
0000001111111101111000000
0000001111111101110000000
0000000111111110110110000
0000000001111110101011000
0000000011111111011110000
0000000001111111111100000
0000000000111111111100000
0000000000001111111000000
0000111100011111111000000
0000011111111111110000000
0000111111111111000000000
0000001111100000000000000
0000011111000000000000000
0000000110000000000000000
0000001100000000000000000
0000000000000000000000000