0000000011111111110000000
0000011111000000111110000
0000110000000000000011000
0001100000000000111101100
0011000000000111111110110
0010000000001111111110010
0010000000001110001110010
0010001000000100000100010
0010100010000100000110010
0010001000001100001111010
0010011000001110001011010
0010110000000001101000010
0010111000001100111110010
0010111000001110111111010
0010011000000101111011010
0010010000000110011011010
0010010000001111101110010
0010010000001110110110010
0010010000011110111110010
0010010000111111011010010
0010010111111011100110010
0010111011100001111100010
0011111100000001111100010
0010111000000011111110010
0011111111111111111111110