0101010000000000111000000
0010100001100011000100000
0010100011011111010111000
0000000111111111111111100
0011001111111111111111110
0011001111111111111111110
0111100010101010110111111
0111100001000000001111111
0111100111101010111111111
1111100011111111111111111
1111110001111100001110111
1111111000000011110001110
1111110000000111111111110
1111000111111011111111110
0000000011111011111111110
0000000011110111111111100
0000000001110111111111100
0000111001101111111111000
0000111101101111111111000
0110011111011111111110100
0111011110111111111110100
0111011001111111111110110
0111100111111111111101110
0110011111111111111101111
1011111111111111111011111