0000000000000000000000000
0000000000000000000000000
0000000000111111000000000
0000000011111111110000000
0000001111111111111100000
0000011111001100111110000
0000111100001100001111000
0000111000001100000111000
0001110000001100000011100
0001110000001100000011100
0011100000001100000001110
0011100000001100000001110
0011100000001100000001110
0011100000011110000001110
0011100000111111000001110
0011100001111111100001110
0001110011101101110011100
0001110111001100111011100
0000111110001100011111000
0000111100001100001111000
0000011111001100111110000
0000001111111111111100000
0000000011111111110000000
0000000000111111000000000
0000000000000000000000000