0000000000000000000000000
0000000000000000000000000
0000000000000000000000000
0000000000010010000000000
0000000000111111000000000
0000000000011110000000000
0000111111111111111111000
0001100000000000000001100
0001001111111111111100100
0001011111111111111110100
0011011111111111111110110
0010011111111111111110010
0110111111111111111111011
0100111111111111111111001
0001111111111111111111100
0011111111111111111111110
0011111111111111111111110
0011111111111111111111110
0011111111111111111111110
0001111111111111111111100
0001111111111111111111100
0000111111111111111111000
0000011111111111111110000
0000000000000000000000000
0000000000000000000000000