0000000000000000000000000
0000000000000000000000000
0000000000000100000000000
0000000000000100000100000
0000000000000110001100000
0110110000000101011100000
0001000000000100111000000
0000000000010101111000000
0000000000010111111000000
0000000000110111111000000
0000000000110111111000000
0000000001110111111100000
0000000001110111111111000
0000000011110111111111110
0000000111110111111100000
0000011111110111000000000
0000000000110100000000000
0000110000010100000100000
0011111111111111111111100
0000111111111111111110000
0000001111111111111000000
1111110000000000000111111
0000001111111111111000000
0000000000000000000000000
0000000000000000000000000