0000000000000000000000000
0000001100011100000000000
0001111111111111000000000
0011111000001100110000000
0000100000000001100000000
0000010000001011000000000
0000101000010111111000000
0000011000011010001111000
0001100000000110000111100
0001100000000111000011110
0011000000000111100011110
0011000101000011100011111
0110000111000011100001111
0110000000000011100001111
0110000010000111100001111
0011000010001111100001111
0011000111011111000001111
0011100000011111000011111
0001100000001100000011111
0000111000000000000111110
0000011111000000001111100
0000001111111011110110000
0000011100111100101100000
0111111111111111111111111
0100000000000000000000001