0111110111011111000000000
1111111111111111100000000
1100001111100001100000000
1111111111111111100000000
0111111111111111000000000
0000001111000000000000000
0000011111100000000000000
0000110000110000000000000
0011111111111111111111000
0011111111111111111111110
0111100000001110000001110
0111110000011111111000111
0111111000111111111100011
0111111111111110001111111
0011111111111110001111111
0001111111111100000000000
0001111111111100000000100
0000011000110000000001110
0000011000110000000011111
0000011000110000000111111
0001111000111100000111001
0011110000011110000110001
0011000000000110000110011
0111111111111111000111111
0111111111111111000011110