0000000000000000000000000
0000000000000000000000000
0000000000000000011111000
0000000000000000111111100
0000000000000001111111110
0000000000000011111111111
0000000000000011111111111
0000000000000111111111111
0000010000000111111100111
0000011000000111111000010
0001111000000111111000000
0011111100000111111100000
0110111100000011111100000
0111111111110001111110000
0011111111111100111110000
0000001111111110011110000
0000011111111111011100000
0001111111111111011100000
0000001111111111111000000
0000001111111111110000000
0000000111111111000000000
0000011111111110000000000
0000111111111100000000000
0000000000000000000000000
0000000000000000000000000