0000000000000000000000000
0000000000000000000000000
0000000000000000000000000
0000000100000000000000000
0000001000110000000000000
0000011001100000000000000
0000111011100000000000000
0000110011000000000000000
0000110110000000000000000
0000100100000000000000000
0000101100011111000000000
0000111001111111110000000
0001111111111111111000000
0011111111111111111100000
0011011111111101111100000
0011111111111101111100000
0011111111111011111100000
0000001111111011111111000
0000000111111011111100100
0000000011111101111100100
0000011110011111111111000
0000111100111111111000000
0000000000000000000000000
0000000000000000000000000
0000000000000000000000000