0000000000000000000000000
0000000000000000000000000
0000111111111111111110000
0000111110011111111110000
0000111110011111111110000
0000111110011111111110000
0000111110011111111110000
0000111110010011111110000
0000111110010010011110000
0000111110010010010110000
0000100110010010010010000
0000100010010010010010000
0000100000000000010010000
0000110000000000000010000
0000111000000000000010000
0000111000000000000010000
0000111100000000000010000
0000111100000000000110000
0000111110000000000110000
0000111110000000000110000
0000111111000000001110000
0000111111000000001110000
0000111111111111111110000
0000000000000000000000000
0000000000000000000000000