0000000000000000000000000
0000000000000000000000000
0000001111001111000000000
0000000111100111000000000
0000000011110011100000111
0000000000111111111111101
0000000000001111100111110
0000000000111111101111100
0000000011111011111111000
0000000111111011111110000
0000001111111101111001000
0100001111111110011110000
0100001111111111111000000
0110011111111101111100000
0010011111111101111110000
0010011111111110111111100
0010011111111100001111100
0100011111111011111000100
0100011111111111111101000
0110001111111111111100000
0110000111111111111100000
0011000011111111111000000
0001110001110111110111000
0000111111001111111110100
0000000000000000000000000