0000000111111011111100000
0000011111110011111111000
0001111110010010011111100
0011111110000000011111110
0011110011000000110111110
0010110011100001110011010
0000010011110001110010000
0010000011110011110000010
0011100001110011100001110
0011000000110011000000010
0000001100010010001100000
0010011110000000011111010
0011111111000000111111110
0010011110000000011110010
0000001100010010001100000
0011000000110011000000110
0011100001110011100001110
0010000001110011110000010
0000010011110011110010000
0010110011100001110011010
0011110011000000110011110
0011111110000000011111110
0011111110010010011111100
0001111111110011111111000
0000001111110111111000000