0000000000000000000000000
0000000000000000000000000
0000100001000000000000000
0000110011000000000000000
0000111111000000000000000
0000101101000000000000000
0000111111000000000000000
0000111111011100000000000
0000011110111110000000000
0000001101111111000000000
0000000011111111100000000
0000000110111111100000000
0000000110111111100000000
0000000110111111100100000
0000000110111111101110000
0000000110111111101111000
0000000110111111101111000
0000000110111111101111000
0000000110111111100110000
0000000101111111000110000
0000001101111110001100000
0000011101100111111000000
0000111111111111111111000
0000000000000000000000000
0000000000000000000000000