0000000000000000000000000
0000000000000000000011000
0000000000000000011101100
0000000000000001111111000
0000000000000011111110000
0000000000000111111100000
0000000111100111111011100
0000111001101111101011100
0001111111011110110111000
0000001110111111110111000
0001111110111111110110000
0000111101111111110100000
0000001101111110101000000
0000001111111011110000000
0000001011111111110000000
0000001011110011100000000
0000000101111100000000000
0000000010111111100000000
0000000010111111100000000
0000000001010111110000000
0000000000101111111000000
0000000001111111111110000
0000001111100000011111000
0000000011000000000001000
0000001101000000000000000