0000000000000000000000000
0000000000000000000000000
0000000000000000000000000
0000000000001000000000000
0000000000001000000000000
0000000000001000000000000
0000000000001000000000000
0000000000001000000000000
0000000000111110000000000
0001111001111111001111000
0011001110011100111001100
0010000100001000010000100
0000111100101010011110000
0011101110011100111011100
0110001111111111111000110
0100011111111111111100010
0000110111111111110110000
0001100011111111100011000
0001001111111111111001000
0000011000000000001100000
0000010000000000000100000
0000011000000000001100000
0000000000000000000000000
0000000000000000000000000
0000000000000000000000000