0000000000111110000000000
0000000001110011110000000
0110000010001110001100000
0111000010010000110010000
0001110100100011000111000
0000011111111110001101000
0000010111111111110011000
0001111010000011111101000
0011111101111100000011000
0110101101111111111011100
0101101101010000111101100
1101101101101111000110100
1010110110110111111011100
1110110110110111111101100
1101110110110101001110100
1011110110110101110011100
1111010111010101111101100
0110111011011010111110100
0101111011011010101111100
0011011011011010101111100
0010111011101010110101100
0001111101101011010110110
0000011101101101010011010
0000000011111111101111111
0000000000000111111000000