0000000000000000000000000
0000000000000001111111110
0000000000000111101011111
0000000000001100111111111
0000000000011011011001111
0000000000111111110000110
0000000001100000110000010
0000011111011111011110011
0000110011111111111011000
0000000011000000011000000
0000111110111111101111000
0001100111111111111001100
0000000011000000110000000
0001111110111111011111100
0011000111111111111000110
0001111011001100110111100
0011101111011110111101110
0111000000110011000000111
0111111100000000001111111
0111111110000000011111111
0111111111000000111111111
0100000000000000000000001
0111111111000000111111111
0111111110000000011111111
0011111100000000001111110