0000000000000000000000000
0000010000100000000000000
0010010010100000000000000
0011010011100000000000000
0001111100111000000000000
0000001110010000000000000
0000000011010000000000000
0000000001111000000000000
0000000011101000000000000
0000000111111100000000000
0000001110111110000000000
0000001110000000000000000
0000001111000000000000000
0111101111100000111110000
0100110111111111111111010
0000011111111111111111110
0111101111111111111111000
0100110111111111110111000
0000011111111110011011100
0000000000111000001101111
0000000000000000000110011
0000000000000000000011001
0000000000000000000001001
0000000000000000000001001
0000000000000000000011011