0000000000000000000000000
0111111111111000011111111
0111111111110001100001111
0111111111100011001110111
0111111111101110011001011
0111111111110010001100101
0111011111100010000111001
0111000111100010000100001
0111010011100011000100011
0111011001110000111000110
0111001101111001101111100
0111100101111111000000000
0111111001111010000000000
0100000000110011000000001
0001101100010111110001111
0010011111000111111111111
0000111000000111100001111
0011110010100111001100111
0111100110110100011110011
0111101100110001000000011
0111101001110011100011011
0111100011111001111111111
0111110111100000111111111
0111111111001100011111111
0111111111111110001111111