0000000000000000000000000
0000000001111110000000000
0000000110001111100000000
0000001101111111110000000
0000011111101000011011000
0000111111010000001010000
0000111110100001110100000
0001111011000111111011100
1111111100001111111001110
0111100000111111001001110
0000000111111110011001011
0000011111111100110011101
0000111111110000110011011
0001111111001001100111011
0001110110000001100110111
0011101101000001001110101
0011111100000011001101110
0011111110001011001101100
0011011101010111000110100
0011111110001110000111100
0011101111111110000011100
0001111111111100000001110
0000111111111000000000011
0000001111100000000000000
0000000000000000000000000