0000000000000000000000000
0000000000000000000000000
0000111100111111111000000
0011110011111110000000000
0111001111110000000000000
1110111110000000000000000
1101110000000000000000000
1111000000000000000000000
0110000000000000000000000
0010000000000000000000000
0_81_82_83_84_85_86_87_88_89_810_811_812_813_814_815_816_817_818_819_820_821_822_823_824_8
0000000000000010000000000
0000000000000101000001110
0001000000011000110010011
0011110001101111101110001
0001111111000000001110001
0000011100000000011110011
0000000111000000011100110
0000000011110000111111100
0000000000111101110000000
0000000000000111000000000
1111111111011011110111111
0011111111100000001111111
0001111111111111111111100
0000000000000000000000000