0000000000000000000000000
0000000000000000000000000
0000000000000000001000000
0000000000000000101000000
0000000000000000011100000
0000000000000000111110000
0000000000000001110011000
0000000000000011100000000
0000000000000111000000000
0000000000001111000000000
0000000000011110000000000
0000000000111110000000000
0000000011111100000000000
0000001111111110000000000
0000111111111110000000000
0001011111111110000000000
0001011111111110000000000
0001111111111100000000000
0000111100010100000000000
0000101000010100000000000
0001101000010100000000000
0001010000010100000000000
0001010000010100000000000
0001010000010100000000000
0000000000000000000000000