0001111111000000000000000
0011111111100000000000000
0000101111110000000000000
0001111111100000000000000
0000011111111111110000000
0000001111111100011000000
0000111011111000001000000
0000001101111100001000000
0000000001111111001100000
0000001111111111101100000
0000111111111111110000000
0001110000111111110000000
0011010000111111111000000
0010000000111111111000000
0010000000111111111000000
0010000001111111111000000
0110000001111111111000110
0100000001111111111001111
0100000001111111111111111
0100000001000000000000111
1100000001000000000000111
1000000011000000000000111
1000011111000000000000010
1000111111000000000000000
1000111110000000000000000