0000000000000000000000000
0000000000000000000000000
0000000000000100000000000
0000000000001110000000000
0000000000111111000000000
0000000000011111111100000
0011111000001111110111000
0111111110111111101111100
0111111111111111101100010
1111111111111111101101011
1111111101111111101100011
1111111101111111101111110
1111111100111111101111111
1111111100011111110111100
0111111110001111111111000
0111111110011011111100000
0111111110111000001100000
1111111110001000011100000
1111111110000000111100000
1111111110000000001100000
0011111110000000000000000
0000111100000000000000000
0000000100000000000000000
0000000000000000000000000
0000000000000000000000000