0111111111011111110111111
1100011111111111111111011
1000000111111111111110101
1001100011111111011111011
1001110110000001111111111
1100111000011110011111111
1100110011111000001111110
1110010111100000100111111
1110011111000000000111111
1111001110011100000010111
1111000110011010110011111
0111100011011100101011111
1111010001100000000011111
1111011000110100000011111
1111011100011000110011011
1101101110001100100111111
1111100011000110000101111
1111110001100011001000111
1111111000110001111100111
1011111110001000011110011
0101111111111110000110011
1011101111111111100000011
1111111111101111111000111
1111111111000111111111111
1101111111101111101111110