0000000110000011110000000
0000001111000111111000000
0000011111101111111000000
0000011111101111111000000
0000011111111111110000000
0000001111111111100111000
0000000011111111101111100
0000001000001111111111110
0000111011000111111111110
0001111011001011111111110
0011111000011001111111110
0110000011111001111111100
0001111011111001111110000
0011111101110001111100000
0000000110000001111110000
0000000110000001111110000
0000001111000001111111000
0000011111000001111111000
0000111111000000111111000
0001111111000000011110000
0001111111000000000000000
0001111111000000000000000
0001111111000000000000000
0001111110000000000000000
0000111100000000000000000