0011111000000000001000010
0110001111111000001000010
1100011111111100001100110
1100111111111110001111110
1100111111111111011101011
0100111111111111001111110
0110011111111111011111111
0011011111111111000111100
0001101111111111100111100
0000101111111111100111100
0000110111111111101111000
0000011011111111111111000
0111001001111111111110000
1101101101111111111110000
1000100100111101111100000
1010100100011100111100000
1011100100010100111000000
1000000100010100110000000
1100001100010101110000000
0110011000010101010000000
0011110000010101010000000
0000000000110101010000000
0000000000100101011000000
0000000000110101101000000
0000000000000110001100000