0000000000000000000000000
0000000000011110000000000
0000000000110011000000000
0000000000000001000000000
0000000001111001011000000
0000001111000011001110000
0111111000011110000011111
0000000000001100000000000
0000000000111111000000000
0000000000111111000000000
0000000000001100000000000
0100000000001100000000001
0110000000001100000000011
0111100000001100000001111
0111110000001100000011111
0111000000001100000000111
0111000000001100000000111
0101100000001100000001101
0001110000001100000011100
0000111000001100000111000
0000011110011110011110000
0000001111111111111100000
0000000111111111111000000
0000000001111111100000000
0000000000011110000000000