0000011110000000001111000
0000001011000000011010000
0000001001111111110010000
0000001000111111100010000
0000001001111111110010000
0000000111010101011100000
0000000011101110111000000
0000010101111011110101000
0000001010111111101010000
0000010101011111010101000
0000001010011111001010000
0000010100100000100101000
0000001001100100110010000
0000000001110001110000000
0000000001111011110000000
0000000011111111111000000
0001100111111111111100000
0011101111111111111110000
0111001111110101111110000
0110001111100100111110000
0110011101100100110111000
0110111101100100110111100
0110111001100100110011110
0110110001000100010001111
0111111111111111111111111