0000100000000000000000000
1000111110000000000000000
1101010001111000000000000
1110011100001110000000000
0111000111000011000000000
0011110001111001100000000
0011111100001100110000000
0111111101100010011000000
0111101110011001001000000
0111001111001101101100000
0111111111101110110110000
0111111111101110110110000
1111111111011111010110000
1111111011011111011011000
1111110010111111111011000
1101110010111111111011100
1011100010111111111111100
1111000001111111111111100
0111000011100000000111110
0000000111111111110000111
0000000111111100011110000
0000001100001111100111100
0000001000000001110001110
0000000000000000011100111
0000000000000000001110001