0000000000011100000000000
0000000000010011100000000
0000000000010000000000000
0000000011111100000000000
0000000000111110000000000
0000000100111110000000000
0000011101111100100000000
0000011100010000110000000
0000111101111110011000000
0000111100111111011100000
0000111101111111011110000
0001111101111110001110000
0001111100010000001111000
0011111101111111001111000
0011111101111111101111100
0111111100111111101111100
0000111100111111101111110
0000000101111111001000010
1111110100010000000000000
1010111100010001111111111
1111111111111111111110000
0111111111111111111000000
0000111111111111110000000
0000011111111111100000000
0000001111111111000000000