0000000000000000000000000
0000000000000000000000000
0000011110000000000000000
0001111111111000000000000
0011111101011111000000000
0011111000010011110000000
0001110000100100011000000
0000111100101011001100000
0000000110010010011110000
0000001111110100100111000
0000111001111101011011000
0000000111011111100001100
0000001100110011000011100
0000000001100001110000100
0001111000000001100100100
0011111111100011010001100
0011111100111110100111000
0001111010010010010010000
0001110001001101000110000
0001111001100100111100000
0000111100100010001000000
0000011111001001110000000
0000001111111111000000000
0000000000000000000000000
0000000000000000000000000