0000000000000000000000000
0000010000000000000000000
0000111000000000000000000
0000111000000000000000000
0000010000001000000000000
0000011111111100000000000
0000000000001000000000000
0000000001111111000000000
0000000011111111100000000
0000000111111111110000000
0000000111111111110000000
0000000000000000000000000
0000111111111111111110000
0000011111111111111100000
0000011111111111111100000
0000011111111111111100000
0000011111111111111100000
0000011000000000001100000
0000011011111111101100000
0000011011110111101100000
0000011011111111101100000
0000011000000000001100000
0000011111111111111100000
0001111111111111111111000
0000000000000000000000000