0000000000000000000000000
0000000000000000000000000
0000111000111110001111000
0000110001100011000111000
0000000011000001100011000
0000000010011100100011000
0000101010111110110001000
0000101010111110010001000
0000101010111110010001000
0000010100111110010001000
0000010100111110110001000
0000001010011100100011000
0000001011011001100001000
0000100111000011000000000
0000100111100111111100000
0000100011111100000110000
0000110011111011111011000
0000110001111001111101000
0000111000111110111011000
0000111100111011010110000
0000111100011101101100000
0000111110001100111000000
0000111111000100000001000
0000111111100010000011000
0000000000000000000000000