0000000001100011011110001
0000000011100111111100111
0000110111011100011111110
0000111110101111101111110
0000001100110111110001100
0000110010011011111111000
0001111110101100101111100
0111110110110110000000000
1111101110010010000000000
0111011100010011000000000
1110111000010001011100000
1101110011101010111111100
1011101111110111111111110
1011001111101111111111111
1110011011101111111111111
1100110111011101111111111
1100101111011101111111111
0110110111011101111111111
0000101111011101111111111
0000110111011110011011111
0000011011101111100111110
0000011101110111111110100
0000001111111001111111000
0000000111111110111100000
0000000001101100000000000