0000000000000000000000000
0111111110000000111111110
0111111100000000011111110
0111111001100011001111110
0111111011111111101111110
0111111001100011001111110
0111111100000000011111110
0111111111000001111111110
0111111100000000011111110
0111100000000000000011110
0111000000000010000001110
0110001100000111011000110
0100011000000000001100010
0100110000000000000110010
0000100000000000000010000
0000100000000000000010000
0000100000000000000010000
0100010000000000000100010
0100111000000000001110010
0111111110000000111111110
0111111101111111011111110
0111111100001000011111110
0111111110001000111111110
0111111110001000111111110
0111111111001001111111110