0000000000000000000000000
0000000000000000000000000
0001111111111111111111000
0001111111011111011111000
0001101111111110001101000
0001111111111100000111000
0001111111101110001111000
0001111111111111011111000
0001111111111111111111000
0001110011111111111111000
0001000000111111111011000
0000000000111011111111000
0000000000001111111111000
0001010101111111111111000
0001010101111111111111000
0001010101000110111000000
0001010101111111001111000
0001010101111000111111000
0001010101111110001110000
0001000001111100000111000
0000000000111000111111000
0001000000011110000111000
0000011111110000100001000
0000000000000000000000000
0000000000000000000000000