0000011111100000000000000
0000111111110000000000000
0001110000111000000000000
0001100000011000000000000
0011000000111000000000000
0011111001110000000000000
0111111101100000000000000
0111111110000000000000000
1111111111000000000000000
1111111111100100000100000
1111111111100110001100000
1111111111100111011100000
1111111111110111111100000
1111111111110111011010000
0111011111110111111110000
0111001111111111111110000
0111001111111011111100000
0111001111111101100010000
0011000111111111111110000
0011100111111111011110000
0001100011111111101111000
0001100001111111111011100
0001100000001111111110111
0000000000000001111111111
0000000000000000000111111