0000000000001000000000000
0000000000011000000000000
0000000000010100000000000
0000000000010100000000000
0000000000011100000000000
0000000000000000000000000
0000000000011100000000000
0000000000010100000000000
0000000000010100000000000
0000000011110111100000000
0000011111010111111000000
0011110111110111011111000
0111111111111111111111110
1110111101111111111101111
1111111111110111101111111
0111111111111111111111110
0100111100011110011110010
0110011000001100001100110
0011000001000000100001100
0011011001001100101101000
0001011001001100101101000
0001011001001100101101000
0001011001001100101101000
0001100000000000000011000
0000111111111111111110000