0000000000000000000000000
0000000000000000000000000
0000000001110000000000000
0000000011110000000000000
0000000011110000000000000
0000000011110000000000000
0000000001110000000000000
0000000000111110000000000
0000110001111111100000000
0000110011111111110000000
0000111111111110111000000
0000011110111110011100000
0000000000111110001100000
0000000000011110000000000
0000000000011111000000000
0000000000111011100000000
0000000001110001110000000
0000000011100000111110000
0000000011100000011111000
0000000001110000000011000
0000000000110000000010000
0000000000110000000010000
0000000001100000000000000
0000000000000000000000000
0000000000000000000000000