0000000000000000000000000
0000000000000000000000000
0011000000000000000011100
0010011111111111111001100
0010111000000000011100100
0000111011111111011110100
0001010111111111101010100
0001101111110001110110100
0001101111110110110110100
0001101110000110110110100
0001101101111111010000100
0001101111111111011110100
0000000100111111011110100
0001101110011110111000100
0001101100011101111110100
0001101110001011111110100
0001101111100011111110100
0001101111100110111110100
0001101111100111011110100
0000000011101111101100100
0001101111001101101110100
0001101110001011101110100
0001101100011011101110100
0000000000000000000000000
0000000000000000000000000