0000000000000000000000000
0000000000000000000000000
0000000000111111000000000
0000000000111111111000000
0000000001100011111110000
0000000001100000011111000
0000000011000000001111000
0000000011000000001111000
0000000111000000001111000
0000000111110000001111000
0000000111111110011110000
0000001100100111111100000
0000001111100111111100000
0000011001111100111000000
0000011111001111111000000
0000011011111011110000000
0000111111011111110000000
0000110011110011110000000
0001111110011111100000000
0001100111110111000000000
0001111100111111000000000
0001111111101110000000000
0000011111111110000000000
0000000111111100000000000
0000000000000000000000000