0000000000000000000000000
0000000000000000000000000
0000000000000000000000000
0000000000000000000000000
0000111111111111111111100
0000000111111111111111100
0000011110110011000111100
0001110000110011000001100
0010111000111011100011100
0000011100111011100011000
0000001110111011110111000
0000000111111011110111000
0000000011111101111111000
0000001111111101111111100
0001110011111111111111100
0011000111111111111111100
0011010111111111111111100
0000101111111111111111100
0000011111111111111111000
0000000011111111111110000
0000000000011111110000000
0000000000000000000000000
0000000000000000000000000
0000000000000000000000000
0000000000000000000000000