0000000000000000000000000
0000000000000000000000000
0000001111000000000000000
0000111111000000000000000
0001111111100000000000000
0001111111110000000000000
0001111111110000000000000
0001111111111000111100000
0001111111111001111110000
0001111111111001111111100
0000111111001011111111100
0000011100001111111111100
0000001110000000101111100
0000011110000000001111100
0001111000000000011111100
0011111000001100011110000
0011111000011100111100000
0111111001011111100000000
0111111011110110000000000
0111111111100011100000000
0111111111100001111111100
0011111111000000000011111
0011111110000000000000011
0001110000000000000000000
0000000000000000000000000