0000000000000000000000000
0000000000000000000000000
0000000011100000000000000
0000000111110000000000000
0000011111111000000000000
0000001111111000000000000
0000001011111000000000000
0000011111110000000000000
0000001111110000000000000
0001100111100000000000000
0001110001111100000000000
0000011101111111000110000
0000001111111001111111000
0000000001111000111111100
0000000001111100111111000
0000001111111101111110000
0000011111111100111100000
0010111000001110011000000
0011110000000111000000000
0001100000000011000000000
0000000000000001100000000
0000000000000001100000000
0000000000000011100000000
0000000000000000000000000
0000000000000000000000000