0000000000000000000111111
0000000000000011111100000
0000000000001111100000000
0000000000111111000111111
0000000001111110011100000
0000000111111110110000000
0000001111111110000111111
0000011111111111001100000
0000110011111001100000111
0001101101111000111111100
0011101101101100101110111
0111110011000100100100000
0111111111000100100100011
1111111110000100100100110
1110111100001101101111011
1111000000011001001100000
0111100000101011011000001
0011111111010010010000011
1111000000100110110001111
0111100000001100100111011
0001111111111001101110110
0000011111111111000111100
0000000111111000000011000
0000000000111111000000000
0000000000000001111111111