0000000000000000111110000
0000000000000011000011000
0000000000000110000001100
0000000000001100001100110
0000000000001000000000010
0000000000001111001110011
0000000000011011001101001
0000000000010010000001001
0000000000100101100011001
0000000000100100000010001
0000000011100101100110001
0000001110101110111111011
0000011000011000000011110
0000110000000000000011000
0000100100000000000001000
0001100110010000000001000
0001000010010000100011000
0011000010011000111010000
0110100111001001110111000
1101101001111000011001100
1001100000111100001000111
1001111111100111111111100
1000110000000000000000011
1100001000000111101111111
0111111001111111111111111