0000000000000000000000000
0000000000000001000000000
0000000000000001000000000
0000000000000111000000000
0000000000011100001000000
0011000000011000001000000
0001111100110000001000000
0000000110111101111000000
0000000011111111111000000
0001111111111111111000000
0011111111111111111111100
0010001111111111111001100
1110001111111111111000000
0000001111111111110000000
0000011111111111110000000
0000011111111111100011111
0000011111111111111110000
0000000111111011000000000
0000000000011011000000000
0000000000110011000000000
0000000011100110000000000
0000000111001100000000000
0000001100001000000000000
0000001000001000000000000
0000000000000000000000000