0000000000000000000000000
0000000011000000110000000
0000000101100001101000000
0000000011110011110000000
0000000000111111000000000
0000000001111111110000000
0000000011111111111000000
0000000111011101111100000
0000001110100010111110000
0000011111111111111111000
0000111000101010001111100
0001111100111110011101100
0001111110101010111100000
0001101101111111011100000
0000001110100010111100000
0000001111111111100000000
0000000000001110000000000
0000011111110111000000000
0000111010000010000000000
0001111000000010000000000
0001010000000001000000000
0000000000000001000000000
0000000000001111100000000
0000000000000011000000000
0000000000000101000000000