0000000000000000000000000
0000000000000000000000000
0111111111111110111111111
0111111111111000111001111
0111111111110011100011111
0111111111100110001111111
0111111111101110111100011
0111111111101000110001001
0111111111101000000111100
0111111100000000111111111
0110011000000000111111111
0000001000000000000000111
0011100000000000111110001
0011110000000000000011100
0100000000000000111001110
0101110000000000011101111
0001110101100000011111111
0011000101101000111111111
0110011001001111111111111
0110111011011111111111111
0110010011001111111111111
0111011001100011111111111
0111011100111111111111111
0111111110111111111111111
0000000000000000000000000