0000110000000000000000000
0001101000000000000000000
0011001100000000000000000
0010000110000000011111000
0110010011110011110001110
0100111001111111100110011
1100111011111111001111001
1110000111111110011110010
1111011111111111011000100
1111110100111111100111100
1110000000111100011100000
1100000000011000001110000
1000110011001100000011000
0011111101101111110001000
0111101101111111011101000
1111110011111111011111000
1111111111111100111110000
0011111111111111111100000
1100111100011101111000000
1111011000001100110000000
1111111100000100100000000
1111111110000001100000000
0111111001001111000000000
1011110000110111000000000
1111100000001110000000000