0000000000000000001110000
0000000000000000011001000
0000110000000000010111000
0000110000000000100101000
0110010000000001101101100
0111010000000010110011100
0001010000000110101100100
0001110000011001101011000
0010111000010010011011000
0011111000100111000110100
0001111000101110110001100
0000011101101101111100100
0000001110111101101111100
0000001110011001101101000
0000001111011011001101100
0000001111001111011101100
0000000111110011111011100
0000000111111001111011000
0000000011111110000100010
0000000001111111111111110
0000000000111111111111100
0001111110000111111111001
0000000001111000000000111
1111100000000111111111110
0000011111100000000000000