0000000111111111110000000
0000011101110111111100000
0000111100110011111110000
0001111001000011111111000
0011100000000011111111100
0111000001110111111111110
0110011100100010001111110
1110000110000011111111111
1110111011100110011111111
1110000000111111111111111
1110000000000111111110011
1111000010000011111110001
1111000001111101111111001
1011100000111111111111100
1001100000000001111111100
1000000000001100111111100
1000000011011111011111001
1100000000111011111111011
0100000111100100111110010
0110000000111111111100110
0011000000111111110001100
0001100000011011000011000
0000110000001010000110000
0000011000000000001100000
0000000111111111110000000