0000010000000000000011100
0000011000001100000111110
0000011100011110001111001
0000001100111111001111111
0000000110111111101001111
0000000111011111100101110
0000000111101111100011100
0000000011111110000000000
0000000001111111100000000
0000000000111111110000000
0000000000011111111000000
0000000000001111111100000
0000000000001111111100111
0000000000011111101111110
0000000000011111100111000
0011000000111111110000000
0111100000111111110000000
1111111111111111111111111
0000000000000000000000000
1111111111111111111111111
1110111111111111111010101
1111111111111111111111111
1010101110101011111110101
1111111111111111111111111
1010101010101010111110101