1111111111111111011100000
0000111111111111001111000
1011011001100111000100100
1000111110111011000010110
1011011000110011000011011
1011010110101111000011001
0000111000100011000111011
1111111111111111000110111
1110101110011111001010011
1110010111101110011010101
1110110110001110010100101
1110110101101000101101110
1110110110001001101011010
1111111111110011110110110
0000000000000111000100110
0000000000001110011001100
0000000000011001110001101
0000000001110011000011001
0000000111000110110110011
0000001100001000011100011
0001110000111100111000111
1111111101001101110001111
1110000000111011000011111
0111100011111110001111111
0001111111100000111111111