1000000000000000000000000
1110000000000000111101000
1111100000000001111111000
1011111110000001111011100
1011000011110011101111000
0100100000000001110011000
0110111100000011111111000
0010000110000111111101000
1001000000011111111100100
1100000000111000110011100
0110000001100011010101100
0110000011010110011010100
0101000010101101111001100
0100000110101111100011000
0000000101101111001111000
0000001101011110011110000
0000011010011101111100000
0000110001111111111100000
0001111111100011001000000
1100001111111110011001111
0000111111111001100000000
0011111100001110111011000
1111111000000000011100000
1111110000000000000000000
0011100001111111111111111