0001000000000000000000111
0011100000010000000011100
0111110001111100000110000
1111111111111111110100000
1111100100000001110011111
1111101110010010010000000
0000111111111010110000000
0000110001000101010011011
0110110101111101110111111
0110110101111111110111111
0110111111111110111010101
1111100001111100111111111
0000110000111100110000000
1100111001000101110110000
1110111010000001110011100
1110110110000010110011110
1100111100000011110010010
1001101011000010010000000
1001111111000110010000000
1001110111000100010000000
0000111101111100010000111
0000100001101100010011111
0000100001101100010111111
0000100001101100010111111
0000100011101110010001111