0000000000000000000000000
0001000000000000000000000
0011101100000111010000000
0010111101001101100000000
0010110111101000000000000
0011010001100011100000000
0001101111101101111000000
0010010111011010110000000
0011110000111011011000000
0001101110111111011010000
0000011101010111110111000
0001111011101010010111100
0011110111111101101111100
0011110111011111111011110
0111101110111110111101110
0111011110111111011101110
0111011101111111011101110
0111011101111111011101110
0111011101111111011101110
0011101101111111011011100
0011101110111110111011100
0001110110111110110111000
0000111011011101101110000
0000001111110111111000000
0000000000000000000000000