0000000001111111000000000
0000011110011001110000000
0011110111001110010000000
0111000001110011101000000
0001111110011000111000000
1111100111001111111100000
0110000001101111000110000
1011111100111100101010000
0110001111110010000001000
1101110011101000111111000
1110111111100011111111000
0011000111010111010101100
1001111110001111111111100
0111110010101101110000110
1111001110011111100000010
1100111101011111001111010
1001100100110010000010001
1011001110101101011000001
0110001111101101001110011
1110011101110010000000110
1100111000111111100011100
1001110011011101110000010
1011010110111100111100110
0110010100110110010111111
0100001101100111011101101