0000000000000000000000000
0000000000000000000000000
0001111100000000000000000
0010111110000000000000000
0011111111000000000000000
0111000111000000000000000
1100000111000000001111111
1000000110000011111000000
0000001110001111000111111
0000011100111100011100000
0000111001110001110011111
0001110011100111001110000
0011100111001110111001111
0111001111111111100111000
1111100111111111111100111
1011110011111111111001100
1001111001111111110011001
1100111100011111100110011
1110011111100000001111110
0111001111111111111111100
0011100111111111000011000
0001110000000000011110000
0000111000000000111000000
0000001111111111100000000
0000000000000000000000000