0000011010001011100111100
0000001110001111001100100
1110001100001100010001100
0111100110001100101101000
0101110110111111011101000
0110111111000110011011000
0011111100000000000110000
0000111001111100111111000
0001110011111111111111000
0000111111100001111111100
0011011111000000011111110
0001011110011111011111111
0001111100111110011111111
0001111101101100111111111
0011111110000001111111110
0010001111000011111111011
0000000111111111111111111
0111110011111111111111110
1111011001111111100011011
1110111001111100011001111
1110111011000001110100110
0111110000011110000110011
0010000111100000000011011
0001111000000000000001001
0000000000000000000000101