1100000000111110000011101
1011000001111111000001111
1010100011111111100000001
1011100011011100110000001
1101110010001000110000011
1100111011100110011000011
1100011111000100001000111
1111101110000000011001011
0110110111010101110011111
0011010111000001100111011
1011000011101011111110110
1111110011111111111000110
0111111001111111000001110
0011001001111111100001100
0001100000111111100011000
0001100110111111111111100
1011111100111111111011110
1101111000011111000110010
0001100000001111101100000
0000110000011101111110000
0000111011011000101011000
0011111110011000111011000
0111011100011000110001000
0100001100110000110000000
0000001101100000110000000