0000000000000000000000000
0000000000000000000000000
0000000000000000000000000
0000000101000000000000000
0000011111000000000000000
0001110110100000000000000
0001111111110000000000000
0000000111010000000000000
0000001111110000000000000
0000001110100000000000000
0000001111000011110000000
0000011111111111111110000
0000011111111111111011000
0001111111111111111011000
0011011111111101111011100
0010001111111011110011100
0010001100000011110011100
0011001000000011100001100
0000001000000110111100100
0000011000000100001000000
0000010000001000010000000
0000010000001000010000000
0000100000000000000000000
0000000000000000000000000
0000000000000000000000000