0000000001011010000000000
0000000000111100000000000
0000000000101110000000000
0000000000111100000000000
0000000001110101001000000
0000000000111100110000000
0000000000111101110000000
0000000000101101111000000
0000000000111101110000000
1000000101011111010000000
0110100011101011111000000
1111000010101110110000000
1111010011101101110010010
1101100111101101111001100
0111110011101101110011110
0111011101101101010011110
1011111111111101110011111
0001101111110111101010110
0000111110111110000111110
0001000101101111111101101
0000000001111111101111000
0000000001111101111110000
0000000001111111111000000
1111111111110110000111111
0000000000111110000000000