0000000011111111000000000
0000000111111111100000000
0000001111001111100000000
0000001110000111110000000
0000000100000011110000000
0000111101000101111111000
0011001100000001000001100
0110001110010011100000110
0100001011000110100000010
1100001011111110110100010
1000001011111010101111001
1001011010101010101001101
1001111010101010101100110
1001011010101010101110000
0101011010101010101110000
0110111010101010101110000
0000111010101010101110000
0000111010101010101110000
0000111111111111111110000
0000010000001000001000000
0000011000011100001100000
0000001110110110000100000
0000011111110011101100000
0000011100010111111100000
0000000000000111000100000