1111110000011110001111111
1011111000001001001001111
1000011000001101001000011
1110011000011101111100111
0010011000111100111111100
0010101000111110011111110
0010101001111100001110100
0110011111110011100110110
0100011111111001110111110
0101011111111100011001110
1101011111100110000000111
1000111111000011000000111
1000111111000001100000011
1000111111000100110000111
1010111110000111011011111
1010011110000101111110011
1000011110000100011100001
1100011010001100001100001
0100011000001000011000001
0100101110011001111100010
0110100111111111000011110
0010000000000000000001100
0011000110011001100011100
0001110000000000001111000
0000011111111111111100000