0000000000000000000000000
0000000000000000000000000
0101111111111111111111110
0010000000000000000000010
0010010000000000010010010
0010001000000000010100000
0101001000000000001100010
0101101000000000001100110
0100111000000000000101100
0100011100010000000111000
0100001111010000000110010
0100000011111000001101100
0100000000111100001111010
0100000000000110011100010
0100000000010011010000010
0100000000011101110110010
0100000000001111111100010
0100000000000011011000010
0100000000000011111100010
0100000000000011111110010
0100000000000111111100010
0100000000000111110000010
0100000000001111110000010
0111111111011111110111110
0000000000000000000000000