0000000000000000000000000
0000000000000000000000000
0001111111111100000011000
0001111111111011100001000
0001111111111010100000000
0001111111111011000000000
0001111111111000000000000
0001111111111000000000000
0001111111111000000011000
0000111111110000111111000
0000111111000000011111000
0000011110000000001111000
0000001100000000100111000
0000000000000000111111000
0000000000000001111111000
0001000000000001111111000
0001100000000001111111000
0001110000000011111111000
0001111000000011111111000
0001111100010011111111000
0001111100111011111111000
0001111101111011111111000
0001111100111001111111000
0000000000000000000000000
0000000000000000000000000