0111101111101111001111101
1011110111101110011111011
1001110011100100011100011
1100111001100110110001111
1110001001000011011001110
1111000000000001100111111
0111111100001111110011011
1001100110011000111001111
1100011110001111010001110
1111110101010101111000111
1101001110001110010110101
0000000000000000010010111
1011000001100000010000111
1111100000000000111101111
1111100011110011001011101
1110110001100010000111111
1011011000001111000001111
1001001111111100000001111
0111100100001110000011101
1110110011100011100111111
1110011000011000001111011
1100001110000111111011111
1000111111111111111111111
1011111101111111110111101
0111111111110111111111111