0000000111111000000000000
0000001111001100000000000
0000001110101100000000000
0000001100000010000011100
0000001110000110001110000
0000001100011100110001111
0000001110001011101110001
0000000111111100011000110
0000000010011111100111000
0011100111100101000001000
1111111100011110110001000
1000001110111110011111110
0111110011111111101000001
0011100111000111110000001
0001001100011001111111111
0001001000111110111111111
0001011011100110011111110
0001010111111000011101000
1101010110111110001101011
1101010100001110001101011
1101011000011110001101011
1101001001111100011001011
1011101100111000110011101
0111110111000011101111110
1100011001111110011000011