0100100000001111111100000
0100100000111000000111000
0100100001100010000001100
0101100011000011111000110
0101100010000000001000010
0101100110000001101000011
0011110100000001101111001
0011111100011000000001001
0111111100010000001101001
0111111100011101001101001
0111111110000110000001101
0000111110000011000000011
0100001011000001010000010
0100001001110001110000110
0100011001110000000001100
0100110001111000000011000
0101100000001110001110000
0101110000000111111000000
0011111000000011111110000
0011011100011111111111111
0111101110110011111111000
0110110111100001111100000
0111011011000001111000000
0101101100000000111000000
0110110011111110110111111