0000000000000000000000000
0000010000000010000000000
0000011000000110000000000
0000010110011110000000000
0000011111111100000000000
0000011111111110000000000
0000111011110110100000000
0000111110011111000000000
0001111111111111000000000
0000111101101111000000000
0001011110011110110000000
0000000111111000000010000
0000000011110000000011000
0000000011110000000001000
0000000111111000000001100
0000001111111100000000100
0000001111111110000000100
0000111111111111000000100
0001111111111111100000100
0001111111111111110000100
0001111111111111110001100
0001111111111111100011000
0000111111011111111110000
0000011111001111100000000
0000000000000000000000000