0000000000000000000000000
0000001110000000000000000
0000000011001111111111000
0000111100111111110011100
0000001011111111010011110
0011110111111011011111111
0000101111011001011110000
0111011111001111001111100
0001011101111111100000000
0110111100111100000000000
0000111011110010000000000
0110110111001110000000000
0001101110001100000000000
0001111100001100000000000
0001011010001000000000000
0001111010000000000000000
0001010010000000000000000
0001110000000000000000000
0001010000000000000000000
0001110000000000000000000
0011111000000000000000000
0011111000000000000000000
0111011100000000000000000
0111001100000000000000000
0110000000000000000000000