1011111011111111111001111
1110001110111111111001101
1100111111110111110011111
1100111111111111110111110
1100111101111000110111111
0110001111110000011111101
1111111111100000001111111
1111110111000111000111111
1011111110001111100011111
1111111100011111110001111
1111111100111111111001111
1111111111110010011111111
0000000000110010011000000
0000000000111111111011100
0000000000000000000000110
0000000000000011111111110
0000000000111111111111000
0000000111111111000000000
0000011111111000000000000
0001111111110000000000000
0111111111000000000000000
1111111110000000000000000
1111111110000000000000000
1111111100000000000000000
1111111100000000000000000