0011110000111100000000000
0111100011111110000011100
1111100111111110000111110
1111000111111111001111111
1111001111111101001111111
1110011001110001001100111
1110010011011011000100001
0111011011111110001110000
0011001110110100011111100
0001000011001100011111110
0001111001111001111111110
0011111110011011001111111
0011111011011010011110001
0111110001011011011011001
1111111111001101111111011
1111110101101100101101110
1110011100101110100001100
0011001001100110110011101
0001111011100110011111001
1110001110110110000111011
1111100000110011001110011
0111111100011011011100111
0011111111011011111011111
0000111111111111110111110
0000000000011111111111000