0000000000000000000000000
0000000000000000000000000
0000000000000000000000000
0011100000000000000011100
0111111000000000001111110
0111111100000000011111110
0111111110011100111111110
0011100111111111110011100
0000111011111111101110000
0000000111111111110000000
0000001110011100111000000
0000001100101001011000000
0000011100001000011100000
0000011111111111111100000
0000111111110111111110000
0000111111101011111110000
0000111111111111111110000
0000111111111111111110000
0000111111111111111110000
0000011111100011111100000
0000011111000001111100000
0000001110000000111000000
0000000011111111100000000
0000000000000000000000000
0000000000000000000000000