0111111100
1100000110
1000000010
1101001111
0111011101
0101111101
0111110101
0110111101
0111111111
0111111100