0000011110
0000111000
0011111000
0111111101
0101111111
1101011111
1111011111
0110111101
0011110001
0000111100