0011100000
0100010000
0101010000
1100010000
0100011111
0100000101
0100011101
0110000011
0011111110
0000101000