0000011111
0000111110
0001110000
0110001111
0110101001
1111111001
1111111111
1111111111
1111111111
0111001110