0000100000
0000100000
0001101000
0001101000
0011101100
0111101110
1111101111
0000010000
0111111110
0011111100