0000111110
0000001000
0000011101
0011111111
0110000001
0100111111
0101000001
0111000000
0010000000
1111111111