0110000000
1010000000
1110100000
0011010000
0011101000
0111110100
0011111000
0011111001
0111111101
1110011111