0001001000
0011001100
0111111110
1001110011
1101111011
1001010011
1111111110
0000110000
0000111101
0001111111