0000000010
0000000100
1111111111
1100001011
0110010110
0011111100
0000110000
0000110000
0000110000
0001111000