0000011111
0001101101
0011101011
0010110110
0110101010
0111011110
0110100100
0101111100
1111110000
1000000000