0001111000
0011001100
0100000010
1001001001
1000000001
1111111111
0010101010
0100100101
0101000101
1101000101