0111000000
1010100000
1111100000
1101000000
0110000000
0110000000
0110001110
0111011111
0111111011
0011110000