0000011001
1100011001
1100001111
0001111100
0100001100
0111111100
0000001100
0000001000
0000001110
0000000010