0011001100
0110011110
0110111001
0010000000
1000101110
1110000111
0111010011
0000110101
0001110100
0000000100