0001111000
0010000100
0100001110
1011001101
1011000001
1000000111
1111111111
1101001011
0100000010
0111111110