1001111001
1111001111
0010000100
0111001110
1100000011
1000110001
1000000001
1101111011
0110000110
0011111100