0000011000
0000101000
0001111101
0111001111
1101000101
1111000101
0110101111
0001111101
0000101000
0000011000