0000000000
0100111000
0001110001
1011111011
0101111111
1111111111
0111111011
0001110001
0000111000
0000000000