0000000111
0111000011
1101000001
0111000000
0111100000
0110111111
0110011110
0111011000
0111100001
0001100011