0000110000
0001001000
0001001000
0000110000
0100110010
1100110011
1110110111
0111111110
0011111100
0000110000