1000000100
1101011100
1010101100
1101010110
1000000101
1000000101
1000000101
1111111110
1111111100
1111111100