0001000000
0001000000
0011100000
1111100000
1111110010
0001111001
0001111101
0001111111
0000101111
0001111110