1101111011
0011111100
1111101111
0110000110
0101001010
0100000010
1001111001
1000110001
0100000010
1011111101