0000001110
0000011000
0000101100
0001100100
0010000100
0111001110
1001110011
1011110111
1111011111
0110001110