0001111000
0011001100
0110000110
1100000011
1000000001
1100110011
1011001101
1010000101
1100000011
1111111111