0110000110
0111001110
0011111100
0001111000
1111111111
1111001111
1110011101
1100111001
1001110001
1111111111