0110000110
0001001000
0001111000
0011111100
0110110110
0110110110
0111111110
1011111101
0011001100
0001001000