0111001110
1101111011
1000110001
1000000001
1100000011
0110000110
0011001100
0001111000
1111111111
0011111100