0000011011
0000000011
0000000100
0100000001
1100011001
1100111100
0111111110
0111111110
0000100100
0001101100