0001100000
0010110000
1111010000
0010011101
0001110011
0011011010
0011000010
0001111110
0000011000
0000110000