0001100000
0000100000
1111011111
1111011101
1000000111
0101010010
0000000001
0000000010
1000000111
1111111111