0010010010
0011010100
0001110101
0000101111
0000111100
0001001011
1110101110
1000001000
0111001100
0001000111