1111011111
1011010111
1111011111
0110001110
1111011111
1001010001
1011010101
1101010001
1001010111
1111011111