0000000000
1010000101
1110000111
0101001010
0101111010
0011111100
1111111111
0011111100
1101111011
1000000001