1101111111
1000011111
0000000011
1111111111
1011010111
0110011101
0000110011
0000000011
1001110111
1100001111