0000001110
0011010001
0011011111
0011001010
0111111110
1010001110
1010011011
0111110101
0101111011
0011001110