0111110000
1000011110
1000001001
1010001001
1000101001
1010111001
1010000001
1010000001
1110111101
0011100111