1111001111
1001111001
1100000001
0101010011
0100000010
0111100001
1000010001
1101010001
1000010011
0111111110