1110000011
1000011001
0011111100
0111110110
1110111100
1100011001
1001000011
1100001111
0110011110
0011111000