1111111111
1011100011
1011001101
1011011001
1011010101
1011001101
0001011001
1011100011
1011110111
1111111111