1100000011
1110000111
1011111101
1100110011
1001001001
1100110011
1110100111
1001111001
1100000011
0111001110