1111000111
1001001001
1000101011
0100110100
0011011000
1101111110
0101101010
0011101110
0001010001
0010001000