0000001111
0000000111
0110000011
1110001011
0111111011
0111110011
0011100011
0001000011
1111111111
0000000011