0011000000
0110100000
1000100000
0110100000
0011110110
0000111001
0001010001
0011010011
1101010011
0001001110