0010001110
0110010001
0010011100
0110010010
1100011000
1111110100
0111100000
0011000000
0001000000
0001000000