0011011100
0100100010
1010011100
1100110000
0111011011
1000100101
0111000110
0001101100
0010001000
0011111000